id,sku,name,price,short_url,original_price,discount,discount_rate,review_count,rating_average
276159943,4586901579152,NEXUS - Lược Sử Của Những Mạng Lưới Thông Tin Từ Thời Đại Đồ Đá Đến Trí Tuệ Nhân Tạo,243750,https://tiki.vn/product-p276159943.html?spid=276160116,325000,81250,25,53,4.8
273844986,3833117471983,"Nói Chuyện Là Bản Năng, Giữ Miệng Là Tu Dưỡng, Im Lặng Là Trí Tuệ",113400,https://tiki.vn/product-p273844986.html?spid=212356653,189000,75600,40,369,4.8
273844978,8786838826491,Thao Túng Tâm Lý,101400,https://tiki.vn/product-p273844978.html?spid=167940011,169000,67600,40,1411,4.7
272449818,5074965088463,MANIFEST – 7 Bước Để Thay Đổi Cuộc Đời Bạn Mãi Mãi,58100,https://tiki.vn/product-p272449818.html?spid=272449819,89000,30900,35,99,5.0
271379451,8865080400814,Lý Thuyết Trò Chơi,110980,https://tiki.vn/product-p271379451.html?spid=271379452,179000,68020,38,422,4.7
270546273,3955850316130,Combo Tư Duy Ngược + Tư Duy Mở (Nguyễn Anh Dũng) SBOOKS ,135000,https://tiki.vn/product-p270546273.html?spid=270546274,276000,141000,51,125,4.7
263070154,3183328469252,Giải mã Hoóc-môn Dopamine,127400,https://tiki.vn/product-p263070154.html?spid=263070155,198000,70600,36,123,5.0
196515658,3091437735835,Blue Period - Tập 04,44700,https://tiki.vn/product-p196515658.html?spid=196515662,48000,3300,7,168,5.0
195801653,8450740041724,Chú Thuật Hồi Chiến - Tập 6,27500,https://tiki.vn/product-p195801653.html?spid=195801659,30000,2500,8,794,5.0
194960721,5669654562758,Blue Period - Tập 03,44100,https://tiki.vn/product-p194960721.html?spid=194960724,48000,3900,8,256,5.0
194959173,7372241689726,Semantic Error – Lỗi Logic (Tập 2),197000,https://tiki.vn/product-p194959173.html?spid=194959175,259000,62000,24,647,4.8
193151000,9182314062218,"Trend Following – Cách thức để kiếm được VẬN MAY LỚN và GIÀU CÓ trong các thị trường BÒ, GẤU và các sự kiện THIÊN NGA ĐEN",599000,https://tiki.vn/product-p193151000.html?spid=193151014,599000,0,0,137,4.7
190861557,5337995399326,Yêu Những Ngày Nắng Chẳng Ghét Những Ngày Mưa,94900,https://tiki.vn/product-p190861557.html?spid=190861559,132000,37100,28,906,5.0
189643105,7150413107642,Không Phải Sói Nhưng Cũng Đừng Là Cừu -Tặng kèm bookmark 2 mặt,78100,https://tiki.vn/product-p189643105.html?spid=189643110,128000,49900,39,1474,4.8
188940817,8460723711989,Vị Thần Của Những Quyết Định,54900,https://tiki.vn/product-p188940817.html?spid=188940819,79000,24100,31,1190,4.8
174301838,5623982635450,BỘ BOOKMARK 1% TINH HOA,49000,https://tiki.vn/product-p174301838.html?spid=174301839,49000,0,0,22,5.0
168283405,6893421095594,Chiến Tranh Tiền Tệ - Phần 1 - Ai Thực Sự Là Người Giàu Nhất Thế Giới ( Tái Bản 2022),116000,https://tiki.vn/product-p168283405.html?spid=168283407,165000,49000,30,783,5.0
161008715,9112392882091,Power Vs Force - Trường Năng Lượng Và Những Nhân Tố Quyết Định Hành Vi Của Con Người (Tái Bản),112770,https://tiki.vn/product-p161008715.html?spid=161008716,179000,66230,37,562,5.0
157432544,8467218185680,Giải Thích Ngữ Pháp Tiếng Anh (Với Bài Tập Và Đáp Án) (Tái Bản),141700,https://tiki.vn/product-p157432544.html?spid=157432545,220000,78300,36,1548,5.0
147920903,1967959392540,Một Thoáng Ta Rực Rỡ Ở Nhân Gian,85050,https://tiki.vn/product-p147920903.html?spid=147920904,135000,49950,37,2051,4.8
145288029,5282892978499,Xứ Cát,149400,https://tiki.vn/product-p145288029.html?spid=145288030,249000,99600,40,1362,4.8
143217512,4078428870578,Điềm Tĩnh Và Nóng Giận,67100,https://tiki.vn/product-p143217512.html?spid=143217516,96000,28900,30,1145,4.8
121635152,4626380643723,Không Ai Có Thể Làm Bạn Tổn Thương Trừ Khi Bạn Cho Phép (Tặng Kèm 1 Bộ Bookmark Gồm 4 Cái),71400,https://tiki.vn/product-p121635152.html?spid=121635153,119000,47600,40,1765,5.0
117238177,5673157495853,Thư Viện Nửa Đêm,97500,https://tiki.vn/product-p117238177.html?spid=117238178,150000,52500,35,1903,5.0
113530805,2220872143049,Tuổi Trẻ Đáng Giá Bao Nhiêu (Tái Bản),56700,https://tiki.vn/product-p113530805.html?spid=113530807,90000,33300,37,1513,4.8
111285062,4190221467193,Đắc Nhân Tâm (Bìa Mềm)(Tái Bản),56300,https://tiki.vn/product-p111285062.html?spid=111285063,86000,29700,35,1080,4.8
106863963,7417324116157,Tâm Lý Học - Phác Họa Chân Dung Kẻ Phạm Tội,105000,https://tiki.vn/product-p106863963.html?spid=106863965,145000,40000,28,6135,4.8
85763211,2349035412093,Hãy Khiến Tương Lai Biết Ơn Vì Hiện Tại Bạn Đã Cố Gắng Hết Mình (Tặng Kèm: 01 Bookmark),75200,https://tiki.vn/product-p85763211.html?spid=89480880,99000,23800,24,179,5.0
74021317,5977911599303,Cây Cam Ngọt Của Tôi,68040,https://tiki.vn/product-p74021317.html?spid=74021318,108000,39960,37,13388,5.0
73787185,6372567555779,Những Tù Nhân Của Địa Lý,132300,https://tiki.vn/product-p73787185.html?spid=73787186,210000,77700,37,4152,4.8
72459686,4125558840055,How Psychology Works - Hiểu Hết Về Tâm Lý Học,195000,https://tiki.vn/product-p72459686.html?spid=72459687,300000,105000,35,3415,4.8
71345381,2019473448712,Sách Thay Đổi Cuộc Sống Với Nhân Số Học - Lê Đỗ Quỳnh Hương,216120,https://tiki.vn/product-p71345381.html?spid=77026805,227500,11380,5,366,4.8
69764541,9554778221279,Tâm Lý Học Hành Vi (Tặng Kèm 1 Bookmark ),73500,https://tiki.vn/product-p69764541.html?spid=69764542,118000,44500,38,2799,5.0
54614797,8002146664322,"Có Một Ngày, Bố Mẹ Sẽ Già Đi",65000,https://tiki.vn/product-p54614797.html?spid=54614798,96000,31000,32,2438,4.8
52789367,5279951395588,Nhà Giả Kim (Tái Bản 2020),49770,https://tiki.vn/product-p52789367.html?spid=52789368,79000,29230,37,5962,5.0
42230121,3098193178849,Sách Hiểu Về Trái Tim (Tái Bản 2019) - Minh Niệm,129400,https://tiki.vn/product-p42230121.html?spid=42230122,158000,28600,18,3701,4.8
17336364,2144215258059,Phía Sau Nghi Can X (Tái Bản 2019),81270,https://tiki.vn/product-p17336364.html?spid=17336365,129000,47730,37,3525,4.8
4780917,3342656016576,Người Đua Diều (Tái Bản 2018),104000,https://tiki.vn/product-p4780917.html?spid=4781791,129000,25000,19,2647,4.8
3954355,3044489264000,Yêu Những Điều Không Hoàn Hảo,83400,https://tiki.vn/product-p3954355.html?spid=3955615,139000,55600,40,3996,5.0
3304875,2929303348245,Điều Kỳ Diệu Của Tiệm Tạp Hóa NAMIYA (Tái Bản),66150,https://tiki.vn/product-p3304875.html?spid=3304877,105000,38850,37,4774,5.0
276155988,4892292511882,Nexus - Lược Sử Của Những Mạng Lưới Thông Tin Từ Thời Đại Đồ Đá Đến Trí Tuệ Nhân Tạo (Yuval Noah Harari),325000,https://tiki.vn/product-p276155988.html?spid=276390859,325000,0,0,0,0.0
275406600,8268219402991,Dẫn Dắt Một Bầy Sói Hay Chăn Một Đàn Cừu,120900,https://tiki.vn/product-p275406600.html?spid=275406603,195000,74100,38,20,5.0
274649745,9459423049473,Luật Tâm Thức – Vũ Trụ Nhất Nguyên Luận,222000,https://tiki.vn/product-p274649745.html?spid=274650071,288000,66000,23,100,4.7
274031576,1669326196919,Series các tập ATTACK ON TITAN,40100,https://tiki.vn/product-p274031576.html?spid=275881882,44100,4000,9,29,5.0
270114030,1361592162849,Combo sách - Biến Mọi Thứ Thành Tiền - Quyển 1+2 - Nguyễn Anh Dũng - SBOOKS,150000,https://tiki.vn/product-p270114030.html?spid=270114031,336000,186000,55,62,4.8
262590428,7899223661173,Búp Sen Xanh,46702,https://tiki.vn/product-p262590428.html?spid=262590431,72000,25298,35,119,5.0
197558905,7320753092551,Komi - Nữ Thần Sợ Giao Tiếp - Tập 13,24300,https://tiki.vn/product-p197558905.html?spid=197558908,25000,700,3,98,4.8
197344455,5845381372171,Ikigami - The Ultimate Limit - Tuyển Tập Những Câu Chuyện Lay Động Lòng Người - Tập 9,43700,https://tiki.vn/product-p197344455.html?spid=197344457,45000,1300,3,84,5.0
196932307,3667856051673,Here U Are – Tập 3,119000,https://tiki.vn/product-p196932307.html?spid=196932312,119000,0,0,291,4.8
196016785,5621799962772,Ikigami - Tập 08,36100,https://tiki.vn/product-p196016785.html?spid=196016786,45000,8900,20,75,5.0
195801686,9751482435841,Black Jack - Tập 13 (Bìa Mềm),27900,https://tiki.vn/product-p195801686.html?spid=195801688,30000,2100,7,122,5.0
187338036,9526203196680,Chiến Tranh Tiền Tệ - Tập 4,121000,https://tiki.vn/product-p187338036.html?spid=187338037,185000,64000,35,250,5.0
184466860,6027901073690,Hành Tinh Của Một Kẻ Nghĩ Nhiều,55900,https://tiki.vn/product-p184466860.html?spid=184466861,86000,30100,35,1771,4.8
173748415,2475296572600,Tâm Lý Học Mối Quan Hệ,70100,https://tiki.vn/product-p173748415.html?spid=173748416,98000,27900,28,371,4.8
171556602,5544600760243,2030: Những Xu Hướng Lớn Sẽ Định Hình Thế Giới Tương Lai (Tái Bản Lần 1),153000,https://tiki.vn/product-p171556602.html?spid=171556603,209000,56000,27,237,5.0
170708233,2330392359694,Thay Đổi Tí Hon - Hiệu Quả Bất Ngờ Atomic Habits (Tái Bản Lần 4),138000,https://tiki.vn/product-p170708233.html?spid=170708234,189000,51000,27,751,4.8
168373800,9326756704395,Sách - Thao túng tâm lý - 1980BOOKS,109850,https://tiki.vn/product-p168373800.html?spid=197748864,169000,59150,35,26,4.5
168293266,9705333957405,Chiến Tranh Tiền Tệ - Phần 2 - Sự Thống Trị Của Quyền Lực Tài Chính ( Tái Bản 2022),119000,https://tiki.vn/product-p168293266.html?spid=168293267,170000,51000,30,383,5.0
161310103,2607035585213,Từ Vựng IELTS 8.0 - Từ Vựng Đắt Để Đạt Điểm Cao 4 Kỹ Năng,88000,https://tiki.vn/product-p161310103.html?spid=161310104,135000,47000,35,532,5.0
138107485,2064435455665,Mặt Dày Tâm Đen (Tái Bản),109600,https://tiki.vn/product-p138107485.html?spid=138107487,169000,59400,35,347,4.8
109017985,8741635599269,"Thiên Tài Bên Trái, Kẻ Điên Bên Phải (Tái Bản)",129000,https://tiki.vn/product-p109017985.html?spid=109017987,179000,50000,28,5467,4.8
106185389,2680151874471,Tổng ôn ngữ pháp Tiếng Anh cô Trang Anh- Sách luyện thi THPT Quốc gia môn tiếng anh,184000,https://tiki.vn/product-p106185389.html?spid=106185390,250000,66000,26,2534,4.8
104769768,1731013592789,Máy Tính CASIO FX580VN X,694800,https://tiki.vn/product-p104769768.html?spid=104769770,799700,104900,13,840,5.0
104612965,9600488509571,FLASHCARD SachID Moon,5000,https://tiki.vn/product-p104612965.html?spid=104612966,10000,5000,50,87,4.8
95289208,5862624720479,Người Bà Tài Giỏi Vùng Saga,80000,https://tiki.vn/product-p95289208.html?spid=95289212,128000,48000,38,456,5.0
92859698,5771808524305,Tâm Lý Học Biểu Cảm,58800,https://tiki.vn/product-p92859698.html?spid=92859699,98000,39200,40,1503,5.0
91947689,9240011208173,7 Thói Quen Hiệu Quả (The 7 Habits Of Highly Effective People) - Stephen R. Covey - PACE Books,152500,https://tiki.vn/product-p91947689.html?spid=91947690,250000,97500,39,964,5.0
90622579,7876290101854,Tâm Lý Học - Nghệ Thuật Giải Mã Hành Vi,105000,https://tiki.vn/product-p90622579.html?spid=90622655,150000,45000,30,1738,4.8
78598381,7418435709477,Tâm Lý Học Tính Cách (Tặng Kèm: 1 Bookmark),83900,https://tiki.vn/product-p78598381.html?spid=78598428,125000,41100,33,1376,5.0
75307228,9038823919989,Sách OSHO Yêu - Being In Love - Yêu Trong Tỉnh Thức,114000,https://tiki.vn/product-p75307228.html?spid=75307229,168000,54000,32,2119,5.0
53720978,6532535006072,"Trong Cái Không Có Gì Không ? (Thiền Sư Thích Nhất Hạnh Trả Lời Cho Trẻ Em Những Thắc Mắc Về Ý Nghĩa Cuộc Sống, Về Cái Chết, Về Gia Đình, Bạn Bè Và Nhiều Câu Hỏi Khác)",104000,https://tiki.vn/product-p53720978.html?spid=53720979,160000,56000,35,471,5.0
52788072,9010512370783,Chiến Binh Cầu Vồng (Tái Bản 2020),68670,https://tiki.vn/product-p52788072.html?spid=52788073,109000,40330,37,3443,4.8
49747007,9900865226977,Hai Mặt Của Gia Đình,68900,https://tiki.vn/product-p49747007.html?spid=49747008,98000,29100,30,1898,4.8
26114399,6851692325469,"Nóng Giận Là Bản Năng , Tĩnh Lặng Là Bản Lĩnh",64900,https://tiki.vn/product-p26114399.html?spid=26114400,89000,24100,27,7242,4.8
20917699,5242513079264,Làm Sao Học Ít Hiểu Nhiều,98600,https://tiki.vn/product-p20917699.html?spid=20917700,128000,29400,23,543,4.8
19792256,3274339512467,Chuyện Con Mèo Dạy Hải Âu Bay (Tái Bản 2019),31850,https://tiki.vn/product-p19792256.html?spid=19792257,49000,17150,35,2784,5.0
10005245,2496196333059,Đàn Ông Sao Hỏa Đàn Bà Sao Kim,131900,https://tiki.vn/product-p10005245.html?spid=10005246,188000,56100,30,4181,4.8
8885995,8671611615413,Sự Im Lặng Của Bầy Cừu (Tái Bản),74750,https://tiki.vn/product-p8885995.html?spid=8885996,115000,40250,35,2723,4.8
7833728,3908993025659,Dạy Con Làm Giàu (Tập 1) - Để Không Có Tiền Vẫn Tạo Ra Tiền - Cha Giàu Cha Nghèo (Tái Bản),80000,https://tiki.vn/product-p7833728.html?spid=207718377,80000,0,0,2,5.0
3014291,8142774115435,Máy Tính Khoa Học Casio FX-580VN X,707100,https://tiki.vn/product-p3014291.html?spid=3014293,799700,92600,12,5608,4.8
276333509,5048405551295,Cherry Magic (Tập 12),94900,https://tiki.vn/product-p276333509.html?spid=276333624,109000,14100,13,12,5.0
276091633,5704927487115,Hải quỳ ( Bối Khách Bang),122850,https://tiki.vn/product-p276091633.html?spid=276091634,189000,66150,35,12,5.0
275264393,6874904987700,Chia sẻ từ trái tim,112000,https://tiki.vn/product-p275264393.html?spid=275264394,168000,56000,33,119,5.0
273819808,3092195659088,Tâm Lý Học Về Tiền,117180,https://tiki.vn/product-p273819808.html?spid=75953558,189000,71820,38,3632,4.8
272000024,2936371267927,MBA bằng hình (Trọn gói hai năm kiến thức quản trị kinh doanh qua trực quan sinh động),113400,https://tiki.vn/product-p272000024.html?spid=272000026,189000,75600,40,210,5.0
261982682,6845440232938,Cuộc cách mạng Glucose,101000,https://tiki.vn/product-p261982682.html?spid=261982684,158000,57000,36,54,5.0
249875150,2270726656552,Hai số phận (bìa mềm),124000,https://tiki.vn/product-p249875150.html?spid=249875152,195000,71000,36,117,5.0
197587856,7936007640722,Kẻ Thù Không Đội Trời Chung Của Tôi Cuối Cùng Cũng Phá Sản – Tập 1 + 2,240000,https://tiki.vn/product-p197587856.html?spid=197587863,315000,75000,24,144,4.8
197344441,6903620022622,Như Cơn Gió Thoảng - Nghĩ Về Những Qui Luật Cuộc Sống,78240,https://tiki.vn/product-p197344441.html?spid=197344444,115000,36760,32,30,5.0
196851308,7698977658566,Dragon Ball Full Color - Phần Năm: Truy Lùng Cell Bọ Hung - Tập 4,84000,https://tiki.vn/product-p196851308.html?spid=273790699,84000,0,0,0,0.0
194205608,3224291603602,Cherry Magic - Tập 2,92700,https://tiki.vn/product-p194205608.html?spid=194205614,109000,16300,15,288,5.0
192124399,8769644070297,Blue Period Tập 2,44000,https://tiki.vn/product-p192124399.html?spid=192124400,48000,4000,8,469,5.0
192115858,8517155595120,Chú Thuật Hồi Chiến -  Tập 5,29000,https://tiki.vn/product-p192115858.html?spid=192115861,30000,1000,3,924,5.0
185067342,8159930042043,Tô Bình Yên Vẽ Hạnh Phúc (Tái Bản),62100,https://tiki.vn/product-p185067342.html?spid=185067343,88000,25900,29,410,5.0
181699664,1848182468777,Những Ngã Tư Và Những Cột Đèn,130000,https://tiki.vn/product-p181699664.html?spid=181699665,200000,70000,35,137,4.8
179546672,6087229068798,Làm Sao Học Hết Được Nhân Sinh,109850,https://tiki.vn/product-p179546672.html?spid=179546673,169000,59150,35,175,5.0
173882437,1288959099343,8 Vụ Án Hoàn Hảo - Vạch Trần Tâm Lý Kẻ Phạm Tội,94250,https://tiki.vn/product-p173882437.html?spid=173882439,145000,50750,35,524,4.8
173763072,1327286909565,Tâm Lý Học Hẹn Hò - Nghệ Thuật Giao Tiếp Trong Tình Yêu,76200,https://tiki.vn/product-p173763072.html?spid=173763073,109000,32800,30,224,4.8
167972598,4653878269443,Tôi Thích Bản Thân Nỗ Lực Hơn (Ấn Bản Kỷ Niệm),83900,https://tiki.vn/product-p167972598.html?spid=167972599,120000,36100,30,333,4.8
140416370,7822684494840,Dòng Chảy,149400,https://tiki.vn/product-p140416370.html?spid=140416372,228000,78600,34,710,5.0
139303869,6866671666215,Nghệ Thuật Tinh Tế Của Việc Đếch Quan Tâm (Tái Bản),82000,https://tiki.vn/product-p139303869.html?spid=139303870,128000,46000,36,547,5.0
127844385,7165539015477,Kiêu Hãnh Và Định Kiến (Tái Bản),75400,https://tiki.vn/product-p127844385.html?spid=127844386,116000,40600,35,554,4.8
120219394,1493348887961,Tôi Nói Gì Khi Nói Về Chạy Bộ,49400,https://tiki.vn/product-p120219394.html?spid=120219395,76000,26600,35,564,5.0
108684605,2109570254767,Trí Thông Minh Của Sự Tinh Tế,53400,https://tiki.vn/product-p108684605.html?spid=108684606,89000,35600,40,503,4.8
107802183,9759871079058,Sách Sức Mạnh Tiềm Thức (Tái Bản) (Bìa Mềm),83800,https://tiki.vn/product-p107802183.html?spid=107802184,128000,44200,35,930,5.0
103379147,7576087902248,Bạch Dạ Hành (Tái Bản),135850,https://tiki.vn/product-p103379147.html?spid=103379149,209000,73150,35,1157,4.8
85396163,6687454450555,Combo 2 Cuốn: Yêu Những Điều Không Hoàn Hảo + Bước Chậm Lại Giữa Thế Gian Vội Vã (Tái Bản),145600,https://tiki.vn/product-p85396163.html?spid=85396164,224000,78400,35,934,5.0
76013378,2491493924269,Storytelling With Data - Kể Chuyện Thông Qua Dữ Liệu (Cuốn Cẩm Nang Hướng Dẫn Trực Quan Hóa Dữ Liệu),197780,https://tiki.vn/product-p76013378.html?spid=76013379,319000,121220,38,1908,5.0
74341297,8887611660364,Không Sợ Chậm Chỉ Sợ Dừng ,77400,https://tiki.vn/product-p74341297.html?spid=74217683,129000,51600,40,2967,5.0
72308265,8128858354211,Hoa Vẫn Nở Mỗi Ngày,152100,https://tiki.vn/product-p72308265.html?spid=72308266,234000,81900,35,944,4.8
70224520,4849323174496,Băng keo dán nano 2 mặt siêu dính trong suốt dày 1mm dài 2m rộng 3cm và 5cm,30000,https://tiki.vn/product-p70224520.html?spid=150928052,30000,0,0,525,4.6
59262880,5858155258600,Sách Người Bán Hàng Vĩ Đại Nhất Thế Giới (Tái Bản 2020),96900,https://tiki.vn/product-p59262880.html?spid=59262881,148000,51100,35,957,5.0
58695343,1287755981825,Kỹ Năng Giao Tiếp Đỉnh Cao,57600,https://tiki.vn/product-p58695343.html?spid=58695344,96000,38400,40,524,4.8
23416722,6101272032509,How The Body Works - Hiểu Hết Về Cơ Thể,195000,https://tiki.vn/product-p23416722.html?spid=23416723,300000,105000,35,1029,4.8
21367457,3500695291969,Tôn Tử Binh Pháp ( Tái Bản ),57200,https://tiki.vn/product-p21367457.html?spid=21367458,88000,30800,35,847,4.8
15267827,4933955346595,Hoàng Tử Bé (Tái Bản 2019),48750,https://tiki.vn/product-p15267827.html?spid=15267828,75000,26250,35,3477,5.0
8835159,7265668071233,Đời Ngắn Đừng Ngủ Dài (Tái Bản),57100,https://tiki.vn/product-p8835159.html?spid=8835160,85000,27900,33,3162,4.8
7718737,7331106927391,Nghệ Thuật Tư Duy Rành Mạch (Tái Bản),76700,https://tiki.vn/product-p7718737.html?spid=7718738,118000,41300,35,1023,4.8
5067169,4715805599395,Luật Hấp Dẫn (Tái Bản),57850,https://tiki.vn/product-p5067169.html?spid=5411143,89000,31150,35,751,4.8
3608625,9869859661067,Payback Time - Ngày Đòi Nợ,299000,https://tiki.vn/product-p3608625.html?spid=3679503,299000,0,0,4436,4.8
186237324,9409602327838,Thiên quan tứ phúc - Tập 5 (Tiểu thuyết đam mỹ) - Tặng kèm 1 bookmark 2 mặt,110700,https://tiki.vn/product-p186237324.html?spid=186237326,159000,48300,30,183,5.0
183058543,3940628776654,OSHO - Trưởng Thành,97100,https://tiki.vn/product-p183058543.html?spid=183058544,128000,30900,24,129,5.0
162844699,3655925997884,Tạm Biệt Tôi Của Nhiều Năm Về Trước,61750,https://tiki.vn/product-p162844699.html?spid=162844704,95000,33250,35,658,4.8
158019964,7241191404500,Combo 4 Cuốn Bộ Sách: Nuôi Con Không Phải Là Cuộc Chiến (Tái Bản),318780,https://tiki.vn/product-p158019964.html?spid=158019965,506000,187220,37,250,5.0
145289356,6616656535602,"Sách Atomic Habits - Thay Đổi Tí Hon, Hiệu Quả Bất Ngờ ( Những Thay Đổi Nhỏ Tạo Nên Thành Công Lớn/ Tặng kèm Bookmark)",170000,https://tiki.vn/product-p145289356.html?spid=276514987,189000,19000,10,1,5.0
145288026,4953099111968,Chia Rẽ - Tại Sao Chúng Ta Đang Sống Trong Thời Đại Của Những Bức Tường,130000,https://tiki.vn/product-p145288026.html?spid=145288028,200000,70000,35,417,4.8
128649312,2905310794708,21 Nguyên Tắc Tự Do Tài Chính (Tái Bản),35200,https://tiki.vn/product-p128649312.html?spid=128649314,55000,19800,36,176,5.0
115266692,4720696713584,Sách - Ám Ảnh Sợ Xã Hội - Chạy Trốn Hay Đối Mặt,75000,https://tiki.vn/product-p115266692.html?spid=115437042,125000,50000,40,751,4.8
110448022,5411805297010,Ba Phút Sơ Cứu,91000,https://tiki.vn/product-p110448022.html?spid=110448025,140000,49000,35,330,5.0
106864418,4101802575661,Combo 10 Cuốn: Chuyện Xóm Gà,377000,https://tiki.vn/product-p106864418.html?spid=106864424,580000,203000,35,226,5.0
102629318,5735200203251,999 Lá Thư Gửi Cho Chính Mình (*) - Tập 1 - Mong Bạn Trở Thành Phiên Bản Hoàn Hảo Nhất (Tái bản),92800,https://tiki.vn/product-p102629318.html?spid=102629319,129000,36200,28,867,5.0
90887853,6131095988844,Mình Chỉ Là Người Bình Thường (Sách Tô Màu),82800,https://tiki.vn/product-p90887853.html?spid=90887878,138000,55200,40,1561,4.8
86517373,9854614898077,Khoa Học Về Nấu Ăn - The Science Of Cooking,227500,https://tiki.vn/product-p86517373.html?spid=86517374,350000,122500,35,1367,4.8
84970841,1478193941519,Men Chase Women Choose - Chuyện Tình Yêu Bạn Biết Được Bao Nhiêu?,79500,https://tiki.vn/product-p84970841.html?spid=84970842,109000,29500,27,719,5.0
79672197,1217713291104,Bí Mật Của May Mắn (Khổ Nhỏ)(Tái Bản),29400,https://tiki.vn/product-p79672197.html?spid=79672198,45000,15600,35,501,5.0
73515859,4748239598917,Sách OSHO - Can Đảm Là Chính Mình Trong Thế Giới Hiểm Nguy,60200,https://tiki.vn/product-p73515859.html?spid=73515860,88000,27800,32,280,5.0
53532186,1970316242755,Tuyệt kỹ Giao dịch bằng đồ thị nến Nhật – Japanese Candlestick Charting Techniques,499000,https://tiki.vn/product-p53532186.html?spid=53532187,499000,0,0,2322,4.8
52584834,7326121854685,Tư Duy Hệ Thống Trong Công Việc,53400,https://tiki.vn/product-p52584834.html?spid=52584835,89000,35600,40,709,4.7
50414368,1892640849779,Án Mạng Mười Một Chữ,71500,https://tiki.vn/product-p50414368.html?spid=50414369,110000,38500,35,1349,4.8
35283863,3217860347825,Lược Sử Thế Giới,208000,https://tiki.vn/product-p35283863.html?spid=35283864,320000,112000,35,858,4.6
11122712,6797090419297,Bộ sách Làm Giàu Từ Chứng Khoán (How To Make Money In Stock) phiên bản mới + Hướng Dẫn Thực Hành CANSLIM Cho Người Mới Bắt Đầu,700000,https://tiki.vn/product-p11122712.html?spid=74847164,700000,0,0,158,4.8
9948009,3471675350641,Dám Hạnh Phúc,71500,https://tiki.vn/product-p9948009.html?spid=9948010,110000,38500,35,550,4.8
7982628,4120982499787,Suối Nguồn (Tái Bản),262500,https://tiki.vn/product-p7982628.html?spid=7982629,380000,117500,31,1435,4.8
2496281,3092043388563,Đồi Gió Hú (Tái Bản),78000,https://tiki.vn/product-p2496281.html?spid=2496329,120000,42000,35,619,4.8
828621,1263496447936,Dolocher (Trinh Thám),63200,https://tiki.vn/product-p828621.html?spid=52157785,79000,15800,20,100,4.7
641906,2517976269846,Bí Mật Của Naoko,70200,https://tiki.vn/product-p641906.html?spid=641942,108000,37800,35,1428,4.7
540040,2397833057522,Giáo Trình Chuẩn HSK 1 - Bài Tập (Kèm file MP3),118000,https://tiki.vn/product-p540040.html?spid=262529,158000,40000,25,620,4.8
378448,2518407786529,Nhà Giả Kim,71100,https://tiki.vn/product-p378448.html?spid=19771358,79000,7900,10,1,5.0
276123443,3450275981703,Bộ Sách - Rèn Nhân Cách - Luyện Tài Năng:  Bác Hồ,21000,https://tiki.vn/product-p276123443.html?spid=276123738,22000,1000,5,0,0.0
276098486,3104437025647,Đam Mê Và Trừng Phạt,89200,https://tiki.vn/product-p276098486.html?spid=276098490,119000,29800,25,6,5.0
276077522,4666846928248,"Đường Đời Muôn Ngả, Gặp Gỡ Đã Là Nhân Duyên",94250,https://tiki.vn/product-p276077522.html?spid=276078027,145000,50750,35,10,5.0
275025274,4160292412895,Triết Lý Sống Của Chó Và Mèo,142000,https://tiki.vn/product-p275025274.html?spid=275025276,189000,47000,25,8,5.0
274802547,3413205067105,Tư Duy Phản Biện,54200,https://tiki.vn/product-p274802547.html?spid=2429813,54200,0,0,4,4.8
249876840,4754647446871,"Beartown - Thị trấn nhỏ, giấc mơ lớn",136500,https://tiki.vn/product-p249876840.html?spid=249876841,210000,73500,35,57,4.8
214186191,7535107260553,Những Kẻ Xuất Chúng (Tái Bản),100870,https://tiki.vn/product-p214186191.html?spid=214186193,159000,58130,37,69,4.7
212213013,4006893772931,Từ điển tiếng việt dành cho học sinh - khổ to (Tái bản),47250,https://tiki.vn/product-p212213013.html?spid=212213014,75000,27750,37,17,4.8
201845361,5792133950074,"Súng, Vi Trùng Và Thép (Tái bản)",214270,https://tiki.vn/product-p201845361.html?spid=201845365,339000,124730,37,76,5.0
197352631,9572030755035,Anh Em Nhà Motohashi – Tập 3,57900,https://tiki.vn/product-p197352631.html?spid=197352632,68000,10100,15,54,4.7
196515668,3854014350765,"Quán Rượu Dị Giới ""Nobu"" - Tập 11",32000,https://tiki.vn/product-p196515668.html?spid=196515669,40000,8000,20,38,5.0
194104216,6374857263671,Văn Phòng Thám Tử Quái Vật - Tập 11,26300,https://tiki.vn/product-p194104216.html?spid=194104220,30000,3700,12,77,5.0
193411736,4030518827399,Anh Em Nhà Motohashi - Tập 2,62700,https://tiki.vn/product-p193411736.html?spid=193411737,68000,5300,8,73,5.0
191782162,7195278473891,Trên Đường Băng (Tony Buổi Sáng),74670,https://tiki.vn/product-p191782162.html?spid=191782164,105000,30330,29,156,5.0
190238356,8906550582998,Kỷ Luật Bản Thân,113400,https://tiki.vn/product-p190238356.html?spid=190238357,189000,75600,40,206,4.7
186434700,2206871676402,Người Bà Tài Giỏi Vùng Saga – Tập 8,38900,https://tiki.vn/product-p186434700.html?spid=186434702,52000,13100,25,251,4.6
176909221,5956285607454,Ngôi Nhà Bên Bờ Biển Xanh Thẳm,134000,https://tiki.vn/product-p176909221.html?spid=176909223,174000,40000,23,438,5.0
174842858,1363544330591,Sách Sức Mạnh Của Ngôn Từ (Tái Bản 2022),70700,https://tiki.vn/product-p174842858.html?spid=174842859,108000,37300,35,302,5.0
164336673,8652487830713,How The Brain Works - Hiểu Hết Về Bộ Não,214500,https://tiki.vn/product-p164336673.html?spid=164336674,330000,115500,35,132,4.8
162205263,2476958235572,Những Đồ Vật Có Linh Hồn,112000,https://tiki.vn/product-p162205263.html?spid=162205267,149000,37000,25,470,4.7
160997378,7490579538955,"Giải Thích Ngữ Pháp Tiếng Anh Với Bài Tập Và Đáp Án (TB 2022) - Tác giả Mai Lan Hương, Hà Thanh Uyên",187000,https://tiki.vn/product-p160997378.html?spid=272947468,220000,33000,15,0,0.0
159004131,5315848374157,Semantic Error – Lỗi Logic (Tập 1),208000,https://tiki.vn/product-p159004131.html?spid=159004133,259000,51000,20,1346,4.8
157240665,5307482538791,Ra Bờ Suối Ngắm Hoa Kèn Hồng (Truyện Dài-Nguyễn Nhật Ánh),96220,https://tiki.vn/product-p157240665.html?spid=157240667,145000,48780,34,2096,5.0
147988185,6385451721450,"Combo 2 Cuốn ""Hiểu Hết"" : How Business Works - Hiểu Hết Về Kinh Doanh + How Money Works - Hiểu Hết Về Tiền",442000,https://tiki.vn/product-p147988185.html?spid=147988187,680000,238000,35,202,4.8
143186001,8321613830244,Chiến Thắng Con Quỷ Trong Bạn - Bí Quyết Tự Do Và Thành Công (Tái Bản),72450,https://tiki.vn/product-p143186001.html?spid=143186002,115000,42550,37,364,4.8
137741275,1278801668770,"Ngỡ Như Lương Thiện, Hóa Ra Mềm Yếu",87400,https://tiki.vn/product-p137741275.html?spid=137741278,125000,37600,30,220,4.8
126743464,8902163165519,Kế Hoạch Của Linh Hồn - Khám Phá Ý Nghĩa Cuộc Sống Mà Bạn Đã Lên Kế Hoạch Trước Khi Sinh Ra,106470,https://tiki.vn/product-p126743464.html?spid=126743466,169000,62530,37,222,5.0
95218451,1024254918417,Lần Đầu Làm Mẹ - Tổng Hợp Những Kiến Thức Mới Nhất Về Mang Thai Và Sinh Nở (Tái Bản),163800,https://tiki.vn/product-p95218451.html?spid=95218452,260000,96200,37,412,5.0
85029033,4755844917682,Truyện Cổ Grimm (Ấn Bản Đầy Đủ Nhất Kèm 184 Minh Hoạ Của Philipp Grot Johann Và Robert Leinweber),440000,https://tiki.vn/product-p85029033.html?spid=85029034,680000,240000,35,550,5.0
73316977,6398002961929,Hành Trình Của Linh Hồn (Tái Bản 2020),79980,https://tiki.vn/product-p73316977.html?spid=73316978,129000,49020,38,385,5.0
66619715,5805728029969,Sách Vị Tu Sĩ Bán Chiếc Ferrari (Tái Bản),66500,https://tiki.vn/product-p66619715.html?spid=66619716,98000,31500,32,933,4.8
57761618,1634726354803,Vụ Án Mạng Ở Lữ Quán Kairotei,79950,https://tiki.vn/product-p57761618.html?spid=57761619,123000,43050,35,849,4.8
52805060,9262112795163,Chúa Ruồi - Tiểu Thuyết (Nobel Văn Chương 1983)(Tái Bản 2020),57200,https://tiki.vn/product-p52805060.html?spid=52805061,88000,30800,35,896,4.8
52785564,7275212621609,Dịch Hạch (Nobel Văn Chương 1957),83850,https://tiki.vn/product-p52785564.html?spid=52785565,129000,45150,35,600,4.6
50751279,4746981416862,Vui Vẻ Không Quạu Nha - Tản Văn,41400,https://tiki.vn/product-p50751279.html?spid=50751280,69000,27600,40,5335,4.7
25557704,2187540525489,Bãi săn người - Trinh Thám Kinh Dị,105300,https://tiki.vn/product-p25557704.html?spid=52161652,105300,0,0,101,4.8
22881852,4285677051814,English Grammar in Use Book w Ans,169000,https://tiki.vn/product-p22881852.html?spid=22881853,198000,29000,15,2615,5.0
21130350,4030461374330,Vụ Án LEROUGE (Trinh Thám),83200,https://tiki.vn/product-p21130350.html?spid=52156010,104000,20800,20,79,4.8
14053724,5895372587014,Sự Cứu Rỗi Của Thánh Nữ,103000,https://tiki.vn/product-p14053724.html?spid=14053725,128000,25000,20,746,4.8
11371249,6613307763215,Chuyện Con Mèo Và Con Chuột Bạn Thân Của Nó - Tái Bản,25350,https://tiki.vn/product-p11371249.html?spid=11371250,39000,13650,35,714,5.0
276507447,6550791044412,Combo 5 cuốn: Cơ Thể Tự Chữa Lành,539000,https://tiki.vn/product-p276507447.html?spid=94770491,730000,191000,26,428,5.0
276109497,7486457019454,Spy X Family Tập 10 [Tặng Kèm Standee],19750,https://tiki.vn/product-p276109497.html?spid=276109499,25000,5250,21,9,5.0
275946549,8793663511145,Yêu Miêu – Ký Sự Yêu Quái Thành Trường An,167000,https://tiki.vn/product-p275946549.html?spid=275947202,209000,42000,20,5,4.5
273383957,2007159276916,TIỂU SỬ ELON MUSK,314370,https://tiki.vn/product-p273383957.html?spid=273384043,499000,184630,37,51,4.7
272449822,6370037261017,Nhà Tranh,108000,https://tiki.vn/product-p272449822.html?spid=272449823,155000,47000,30,11,4.8
271317275,3432898473291,Ghi Chép Pháp Y – Khi Tử Thi Biết Nói,75000,https://tiki.vn/product-p271317275.html?spid=271317276,125000,50000,40,151,5.0
253212192,2086303531203,[GIFT] - Sổ tay ghi chép mục tiêu - kế hoạch My Day My Life,19500,https://tiki.vn/product-p253212192.html?spid=253212193,30000,10500,35,6,4.3
198016656,5409175203604,Blue Flag - Tập 3,18000,https://tiki.vn/product-p198016656.html?spid=198016657,45000,27000,60,75,5.0
195801644,7521070927406,Black Jack - Tập 13 (Bìa Cứng),126000,https://tiki.vn/product-p195801644.html?spid=195801654,135000,9000,7,46,5.0
193988323,3440211775892,Sa Vào Ánh Hào Quang Của Người – Tập 2,108000,https://tiki.vn/product-p193988323.html?spid=193988327,138000,30000,22,220,4.8
193433626,7233084584993,Kỹ năng tự học cho trẻ tiểu học,129350,https://tiki.vn/product-p193433626.html?spid=193433627,199000,69650,35,36,4.8
187843291,7302391711222,Nhật ký Đặng Thùy Trâm,58500,https://tiki.vn/product-p187843291.html?spid=187843293,90000,31500,35,86,5.0
186286187,3562677301033,Nhà Lãnh Đạo Không Chức Danh,74250,https://tiki.vn/product-p186286187.html?spid=186286189,105000,30750,29,154,5.0
184774173,7199932624176,Những Người Nhật Tử Tế,95000,https://tiki.vn/product-p184774173.html?spid=184774174,148000,53000,36,187,5.0
184070221,6059967643910,Sách OSHO Hiểu - Đường Đến Tự Do,114900,https://tiki.vn/product-p184070221.html?spid=184070222,168000,53100,32,204,5.0
179063564,6024847029566,Tôi Tự Học,83070,https://tiki.vn/product-p179063564.html?spid=179063565,120000,36930,31,235,4.8
168576295,6520009540965,Mình Phải Sống Như Biển Rộng Sông Dài,87300,https://tiki.vn/product-p168576295.html?spid=166033471,109000,21700,20,332,5.0
160759005,9465225365199,Cơ Thể Tự Chữa Lành - Thanh Lọc Để Phục Hồi,168000,https://tiki.vn/product-p160759005.html?spid=160759006,295000,127000,43,327,5.0
153045603,8850035098034,Sách Người Giỏi Không Phải Là Người Làm Tất Cả (Tái Bản 2021),39600,https://tiki.vn/product-p153045603.html?spid=153045604,58000,18400,32,205,5.0
145287904,2224326377639,Sách - Giận (Tái Bản 2021)(Cuốn sách hay của Thiền sư Thích Nhất Hạnh/ Tặng kèm Bookmark),121500,https://tiki.vn/product-p145287904.html?spid=247856041,135000,13500,10,6,5.0
124767703,1577270048929,Cân Bằng Cảm Xúc Cả Lúc Bão Giông (Tặng Kèm Bookmark)(Tái Bản),77700,https://tiki.vn/product-p124767703.html?spid=124767706,105000,27300,26,757,5.0
113540576,6786446721257,Hảo Nữ Trung Hoa,83200,https://tiki.vn/product-p113540576.html?spid=113540578,128000,44800,35,672,5.0
108501279,9384108931281,Viết Đi Đừng Sợ! Từ Tay Không Thành Tay Viết,190000,https://tiki.vn/product-p108501279.html?spid=108501280,245000,55000,22,408,5.0
104314401,9412023196109,Sách Bí Mật Của May Mắn (Khổ Lớn) (Tái Bản),46500,https://tiki.vn/product-p104314401.html?spid=104314402,68000,21500,32,536,4.8
100958457,6567200429771,Gieo Trồng Hạnh Phúc (Tái Bản),55180,https://tiki.vn/product-p100958457.html?spid=100958460,89000,33820,38,372,5.0
100931418,4837536289606,Giao Tiếp Bất Kỳ Ai - 101 Cách Nâng Cao Khả Năng Giao Tiếp (Tái Bản),34650,https://tiki.vn/product-p100931418.html?spid=100931419,55000,20350,37,269,4.8
100931414,3282522023743,Cách Khen Cách Mắng Cách Phạt Con (Tái Bản),43470,https://tiki.vn/product-p100931414.html?spid=100931415,69000,25530,37,129,5.0
76776245,3891511574787,Nghệ Thuật Tư Duy Phản Biện,77400,https://tiki.vn/product-p76776245.html?spid=76776246,129000,51600,40,720,4.8
67271338,8461142635475,Sách OSHO - Trò Chuyện Với Vĩ Nhân,149000,https://tiki.vn/product-p67271338.html?spid=67271339,198000,49000,25,579,5.0
57325187,2446461571372,Sách Người Giàu Có Nhất Thành Babylon (Tái Bản 2020),66500,https://tiki.vn/product-p57325187.html?spid=57325188,98000,31500,32,2504,5.0
52597663,8788427845641,Đừng Chạy Theo Số Đông - Cuốn Sách Bạn Cần Đọc Trước Khi Quá Muộn,126500,https://tiki.vn/product-p52597663.html?spid=52597664,200000,73500,37,1238,4.6
49910019,9853045123569,Bác Sĩ Riêng Của Bé Yêu - Chào Con! Ba Mẹ Đã Sẵn Sàng (Tái Bản),65000,https://tiki.vn/product-p49910019.html?spid=49910020,95000,30000,32,611,5.0
48481763,1057777015651,Thiên Nga Đen (Tái Bản 2020),187420,https://tiki.vn/product-p48481763.html?spid=48481764,299000,111580,37,638,4.8
45321594,8873997958003,Nghệ Thuật Bán Hàng Của Người Hướng Nội,99900,https://tiki.vn/product-p45321594.html?spid=46473460,119000,19100,16,21,5.0
44433397,9951100987405,"Yêu Mình Trước Đã, Yêu Đời Để Sau",78400,https://tiki.vn/product-p44433397.html?spid=44433399,109000,30600,28,691,4.8
32155084,6256169950845,Combo 25 Chuyên đề ngữ pháp tiếng anh trọng tâm ( trọn bộ tập 1+2 ),131000,https://tiki.vn/product-p32155084.html?spid=52334805,230000,99000,43,2611,5.0
17719702,2278779960544,Một Thế Giới Không Có Đàn Bà (Trinh Thám Việt Nam),92400,https://tiki.vn/product-p17719702.html?spid=17719703,142000,49600,35,14,4.5
13624088,4115499144176,Nghĩ Thiện Để Cuộc Đời Và Công Việc Viên Mãn,64700,https://tiki.vn/product-p13624088.html?spid=13624089,85000,20300,24,264,5.0
13419678,9065228641221,Sách Đi Tìm Lẽ Sống (Tái Bản ),57600,https://tiki.vn/product-p13419678.html?spid=13419679,88000,30400,35,2445,4.8
7916685,5779763647146,"All The Rule - Bình Tĩnh Khi Ế, Mạnh Mẽ Khi Yêu",58400,https://tiki.vn/product-p7916685.html?spid=7916686,86000,27600,32,786,4.7
276098484,4598506166126,Đuổi Theo Mùa Hạ - Tập 1,129104,https://tiki.vn/product-p276098484.html?spid=276105723,199000,69896,35,10,4.7
275703607,4101334753296,Ám Ảnh Từ Kiếp Trước - Bí Mật Của Sự Sống Và Cái Chết,56070,https://tiki.vn/product-p275703607.html?spid=71090269,89000,32930,37,965,5.0
274926099,8592950545246,Bài tập Bổ trợ Tiếng Anh 5 i-Learn Smart Start,80000,https://tiki.vn/product-p274926099.html?spid=274926100,89000,9000,10,5,4.8
207830892,3639194481918,"Combo 6 Cuốn (Phát Triển Trí Tuệ Cảm Xúc): Cảm Xúc Của Con Màu Gì? + Chúng Mình Tôn Trọng Cơ Thể Và Cảm Xúc Của Nhau + Con Được Là Chính Mình + Sự Tử Tế Đẹp Như Bông Hoa + Con Kiên Trì, Con Không Bỏ Cuộc + Gấu ơi, Con Lo Lắng Đến Chừng Nào",180000,https://tiki.vn/product-p207830892.html?spid=207830893,300000,120000,40,17,5.0
206678865,8165683694338,Dám Nghĩ Lại,114000,https://tiki.vn/product-p206678865.html?spid=206678866,168000,54000,32,126,5.0
197781977,4143090932209,Yu-Gi-Oh! Gx Tập 1: “Người Hùng Mới” Lộ Diện,14000,https://tiki.vn/product-p197781977.html?spid=197781978,30000,16000,53,39,4.8
197587865,8949063872458,Bách hóa giấc mơ của ngài Dollargut,84500,https://tiki.vn/product-p197587865.html?spid=197587866,130000,45500,35,133,5.0
194104631,8163297214926,Mong Bạn Đừng Khóc Một Mình,61500,https://tiki.vn/product-p194104631.html?spid=194104632,88000,26500,30,34,5.0
193434488,4522903791386,Kingdom -  Tập 32,41300,https://tiki.vn/product-p193434488.html?spid=193434489,45000,3700,8,43,5.0
187622420,7687224635144,The Art and Science of Technical Analysis – Phân tích kỹ thuật: Sự kết hợp giữa KHOA HỌC và NGHỆ THUẬT trong đầu tư chứng khoán,569000,https://tiki.vn/product-p187622420.html?spid=187622422,569000,0,0,66,4.8
186091870,4157254111191,Fullmetal Alchemist - Cang Giả Kim Thuật Sư - Fullmetal Edition Tập 15,69100,https://tiki.vn/product-p186091870.html?spid=186091873,75000,5900,8,99,5.0
182548592,9368857929874,Thiên Sứ Nhà Bên – Tập 3,85500,https://tiki.vn/product-p182548592.html?spid=182548594,95000,9500,10,327,5.0
32490132,8771459670374,Một Đời Như Kẻ Tìm Đường,123000,https://tiki.vn/product-p32490132.html?spid=32490133,175000,52000,30,584,4.8
17881046,7801160509104,Trầm lặng - Sức mạnh tiềm ẩn của người hướng nội,65000,https://tiki.vn/product-p17881046.html?spid=42131414,130000,65000,50,364,4.8
394434,2201531894863,Giấy Excel A4 DL70,55000,https://tiki.vn/product-p394434.html?spid=80078423,55000,0,0,120,5.0
275928713,6416837828890,Đọc Vị Mọi Vấn Đề Của Trẻ - Giải Mã Mọi Vấn Đề Về Nuôi Con Nhỏ: Ăn - Ngủ - Kỷ Luật Hành Vi,169049,https://tiki.vn/product-p275928713.html?spid=275928716,239000,69951,29,574,5.0
275739724,6982397089145,"Bộ bút mực Gel nước / Bộ bút bi mực gel mực đen ngòi 0.5mm dùng ghi chép dành cho học sinh, sinh viên, văn phòng – Bộ 4 cây",39000,https://tiki.vn/product-p275739724.html?spid=275739726,49000,10000,20,0,0.0
275362670,2645254774344,Sakamoto Days Sát thủ huyền thoại,35000,https://tiki.vn/product-p275362670.html?spid=275599500,35000,0,0,11,5.0
275041762,6423726722956,Bộ sách Harry Potter - Tiếng Việt - Khổ nhỏ,88840,https://tiki.vn/product-p275041762.html?spid=275041944,134000,45160,34,38,5.0
274928291,4817477148953,Historie,43100,https://tiki.vn/product-p274928291.html?spid=274928294,43100,0,0,13,5.0
273378780,8739426249005,Nhân Chứng Cuối Cùng,121000,https://tiki.vn/product-p273378780.html?spid=273378782,169000,48000,28,11,4.5
263078153,3853508463658,Từ giờ thứ sáu đến giờ thứ chín (Tiểu thuyết),195000,https://tiki.vn/product-p263078153.html?spid=263078154,260000,65000,25,24,4.6
247302044,1002320225090,Hành trình bánh xe y học_Chữa lành bệnh rối loạn căng thẳng sau chấn thương (PTSD),150000,https://tiki.vn/product-p247302044.html?spid=247302045,200000,50000,25,5,4.6
197990869,9286677136205,Doraemon Movie Story: Tân Nobita Và Chuyến Phiêu Lưu Vào Xứ Quỷ - 7 Dũng Sĩ Phép Thuật,27000,https://tiki.vn/product-p197990869.html?spid=197990870,30000,3000,10,27,5.0
197990867,5659914380156,Doraemon Movie Story: Nobita Và Viện Bảo Tàng Bảo Bối,27100,https://tiki.vn/product-p197990867.html?spid=197990868,30000,2900,10,39,5.0
193605362,4006170965677,Ali Và NiNo,81250,https://tiki.vn/product-p193605362.html?spid=193605365,125000,43750,35,44,4.8
192909291,5930842254895,Văn Phòng Thám Tử Quái Vật - Tập 10,26300,https://tiki.vn/product-p192909291.html?spid=192909293,30000,3700,12,87,5.0
189641379,8376750722968,Anh Em Nhà Motohashi - Tập 1,27000,https://tiki.vn/product-p189641379.html?spid=189641380,68000,41000,60,174,5.0
185232565,4271577822452,Tiếng Anh 7 i-Learn Smart World Workbook (Sách bài tập),70000,https://tiki.vn/product-p185232565.html?spid=185232566,70000,0,0,31,5.0
184466862,6973557130204,Trưởng Thành Là Khi Nỗi Buồn Cũng Có Deadline,62900,https://tiki.vn/product-p184466862.html?spid=184466863,88000,25100,29,124,5.0
168662558,1508152188164,CCMR. Phải Trái Đúng Sai,95000,https://tiki.vn/product-p168662558.html?spid=168662559,155000,60000,39,223,5.0
154245455,4022695906765,Combo 2 Cuốn Nghiền Từ Vựng Tiếng Anh: Học Qua Gốc Từ Bằng Hình Ảnh - Gốc Từ Là Bí Quyết Để Ghi Nhớ Hàng Nghìn Từ Vựng,175000,https://tiki.vn/product-p154245455.html?spid=154245456,270000,95000,35,281,5.0
111582631,5938816107123,Cái Dũng Của Thánh Nhân (Thu Giang Nguyễn Duy Cần) (Tái Bản),81000,https://tiki.vn/product-p111582631.html?spid=199648132,90000,9000,10,0,0.0
109505039,7974071248512,Combo Mindmap English Grammar và Mindmap English Vocabulary - Học Kèm App Online,283240,https://tiki.vn/product-p109505039.html?spid=187581785,388000,104760,27,22,4.8
106605689,7065188819692,Spy X Family Tập 5 - Bản Thường,24200,https://tiki.vn/product-p106605689.html?spid=125089637,25000,800,3,52,5.0
100958444,2295783859145,Hạnh Phúc Cầm Tay (Tái Bản),46500,https://tiki.vn/product-p100958444.html?spid=100958445,75000,28500,38,291,5.0
93249197,2592627958006,22 Quy Luật Bất Biến Trong Marketing,52900,https://tiki.vn/product-p93249197.html?spid=127538948,78000,25100,32,103,4.8
89179374,2234275413015,Spy X Family Tập 4,24300,https://tiki.vn/product-p89179374.html?spid=89179375,25000,700,3,953,4.8
80960198,8972387969497,"Thiên Tài Bên Trái, Kẻ Điên Bên Phải (Tái Bản 2021)",132400,https://tiki.vn/product-p80960198.html?spid=80960199,179000,46600,26,231,5.0
77230663,3295386640893,Combo 2 Cuốn: Tâm Lý Học Tội Phạm,202000,https://tiki.vn/product-p77230663.html?spid=77230664,288000,86000,30,1932,4.8
77109209,2270954610737,Nghệ Thuật Đánh Cắp Ý Tưởng (10 Bí Mật Không Ai Nói Với Bạn Về Sáng Tạo),62370,https://tiki.vn/product-p77109209.html?spid=77109210,99000,36630,37,495,4.8
77105730,1945037129756,Tàn Ngày Để Lại (Bìa Cứng),109850,https://tiki.vn/product-p77105730.html?spid=77105731,169000,59150,35,718,4.8
59293803,1426468158845,A Holistic Approach To IELTS Writing,111510,https://tiki.vn/product-p59293803.html?spid=59293804,189000,77490,41,206,5.0
56218385,2849773990365,Thông Điệp Của Nước (Tái Bản 2020),56070,https://tiki.vn/product-p56218385.html?spid=56218386,89000,32930,37,466,4.7
55506686,8402110556088,Tiktok Marketing,97400,https://tiki.vn/product-p55506686.html?spid=55506687,139000,41600,30,456,4.5
54051756,9173683833904,19 Năm Mưu Sát - Tập 2 (Trinh Thám Trung Quốc),74800,https://tiki.vn/product-p54051756.html?spid=54051757,115000,40200,35,22,4.7
54051754,9677294175915,19 Năm Mưu Sát - Tập 1 (Trinh Thám Trung Quốc),74750,https://tiki.vn/product-p54051754.html?spid=54415636,74750,0,0,97,4.8
52329861,2608828348359,Con Đường Hồi Giáo (Tái Bản 2020),65000,https://tiki.vn/product-p52329861.html?spid=52329862,128000,63000,49,958,5.0
46789754,1466468282164,Hiểu Hết Về Kinh Doanh,247000,https://tiki.vn/product-p46789754.html?spid=46789756,380000,133000,35,810,4.7
20444622,4771691151314,Cẩm Nang Cấu Trúc Tiếng Anh,72600,https://tiki.vn/product-p20444622.html?spid=29878198,98000,25400,26,2686,4.8
14645351,8193023006080,Cuộc Đời Của Pi ( Tái Bản 2019),71500,https://tiki.vn/product-p14645351.html?spid=14645352,110000,38500,35,244,4.8
12377498,3877891187175,Bố Con Cá Gai (Tái Bản 2019),62400,https://tiki.vn/product-p12377498.html?spid=12377499,96000,33600,35,1272,5.0
10405966,7957735455984,Tarot Nhập Môn (Tái Bản 2019),78000,https://tiki.vn/product-p10405966.html?spid=10405967,120000,42000,35,534,4.8
750578,2506010458896,Khi Hơi Thở Hóa Thinh Không,66590,https://tiki.vn/product-p750578.html?spid=750581,109000,42410,39,2266,4.7
595724,2399694264989,Giáo Trình Chuẩn HSK 4 Bài Học (Tập 1),169000,https://tiki.vn/product-p595724.html?spid=595727,228000,59000,26,412,5.0
276107155,6075877969083,Lịch sử Việt Nam bằng hình - Gần 2000 minh họa tranh ảnh và bản đồ,900000,https://tiki.vn/product-p276107155.html?spid=276107156,900000,0,0,8,5.0
273612269,8899538393753,Ghi Chép Pháp Y – Những Thi Thể Không Hoàn Chỉnh,90900,https://tiki.vn/product-p273612269.html?spid=273612270,130000,39100,30,25,5.0
273456914,2157190629285,Series các tập Hội con trai,23400,https://tiki.vn/product-p273456914.html?spid=274358207,23400,0,0,26,5.0
271337379,2897031822340,World History - Lịch Sử Thế Giới,318000,https://tiki.vn/product-p271337379.html?spid=271337380,490000,172000,35,67,4.8
197587849,9950952482650,Yuri Espoir (Tập 3),35000,https://tiki.vn/product-p197587849.html?spid=197587855,79000,44000,56,150,5.0
194104226,3076755833858,"Mô Hình Can Thiệp Sớm Denver Cho Trẻ Tự Kỷ - Thúc Đẩy Kỹ Năng Ngôn Ngữ, Học Tập Và Tương Tác",135000,https://tiki.vn/product-p194104226.html?spid=194104227,210000,75000,36,20,5.0
193978836,5805611059173,Trí Óc Minh Mẫn: Để Não Bộ Sắc Bén Ở Mọi Lứa Tuổi,174000,https://tiki.vn/product-p193978836.html?spid=193978838,249000,75000,30,13,4.5
193434494,6730447817791,Shaman King - Tập 15,30000,https://tiki.vn/product-p193434494.html?spid=193434495,35000,5000,14,48,5.0
187843301,2464186876852,How Technology Works – Hiểu hết về công nghệ,214500,https://tiki.vn/product-p187843301.html?spid=187843302,330000,115500,35,84,4.8
180851000,1514265862532,Bảy Thanh Hung Giản 3 Mưa Phùn Chôn Nho - Truy Lùng Báo Săn Giá,211500,https://tiki.vn/product-p180851000.html?spid=253293168,235000,23500,10,0,0.0
176906726,7518265811713,Chân Dung Thật - Thấu Hiểu Khách Hàng Chỉ Bằng Những Cuộc Trò Chuyện,184000,https://tiki.vn/product-p176906726.html?spid=176906728,245000,61000,25,47,5.0
176654072,7224660607167,Bút Chì Lục Giác 2B HB Deli - Bút Chì Gỗ Thi Trắc Nghiệm Ruột Đậm Bút Chì Học Sinh Cấp 1 Tập Viết Chì Vẽ Phác Thảo,1500,https://tiki.vn/product-p176654072.html?spid=176654074,2880,1380,48,180,5.0
168946125,6533717701922,Digital Marketing - Chiến Lược Là Lược Đi Để Chiến,108020,https://tiki.vn/product-p168946125.html?spid=262694239,108020,0,0,0,0.0
162201947,7976681821733,One Piece - Tập 98: “Phút Huy Hoàng Của Những Trung Thần”,23800,https://tiki.vn/product-p162201947.html?spid=162201949,25000,1200,5,202,5.0
157255752,4871831566007,Sức Mạnh Của Hiện Tại (Tái Bản),114000,https://tiki.vn/product-p157255752.html?spid=157255753,168000,54000,32,266,4.8
147999778,8193957223084,Không Bao Giờ Là Thất Bại - Tất Cả Là Thử Thách (Ấn Bản Cập Nhật Đầy Đủ Nhất)(Bìa Cứng),172400,https://tiki.vn/product-p147999778.html?spid=147999780,268000,95600,36,753,5.0
140635217,9727475614969,Mất Kết Nối (Khám Phá Các Nguyên Nhân Thực Của Trầm Cảm Và Các Giải Pháp Bất Ngờ),195000,https://tiki.vn/product-p140635217.html?spid=140635219,250000,55000,22,185,5.0
140360874,3166575581258,Những Đòn Tâm Lý Trong Bán Hàng (Tái Bản),104000,https://tiki.vn/product-p140360874.html?spid=146196477,139000,35000,25,0,0.0
138226289,6102919526660,Storytelling With Data: Let’S Practice! - Thực Hành Kể Chuyện Thông Qua Dữ Liệu!,300000,https://tiki.vn/product-p138226289.html?spid=138226290,399000,99000,25,326,5.0
137161811,5497243617844,Bút gel bấm ngòi 0.5mm nhiều màu Deli - Độ dài mực lên tới 1000m - 12 màu mực - 1 chiếc - EG118,6500,https://tiki.vn/product-p137161811.html?spid=137161904,11700,5200,44,808,5.0
130997085,2884951453257,Chuyện Con Chó Tên Là Trung Thành,29250,https://tiki.vn/product-p130997085.html?spid=130997086,45000,15750,35,104,5.0
116406678,8281664835912,Quản Lý Nghiệp (Tái Bản),38350,https://tiki.vn/product-p116406678.html?spid=116406679,59000,20650,35,148,5.0
109982846,7703566084687,Vượt Lười - Liệu Trình Cho Người Thiếu Động Lực,58100,https://tiki.vn/product-p109982846.html?spid=109982851,79000,20900,26,105,4.8
106365090,7317972084059,Kinh Dịch Đạo Của Người Quân Tử - Nguyễn Hiến Lê (Tái Bản),173900,https://tiki.vn/product-p106365090.html?spid=106365091,268000,94100,35,264,4.8
105614684,6637213695584,Bút gel 0.5mm Deli nhiều màu lựa chọn - Bút bi nước -  1 chiếc - Mực đỏ / Xanh / Đen - A116,4500,https://tiki.vn/product-p105614684.html?spid=105614689,8100,3600,44,500,4.8
103640412,8098194295063,Đừng Lựa Chọn An Nhàn Khi Còn Trẻ (Tái Bản),64350,https://tiki.vn/product-p103640412.html?spid=103640414,99000,34650,35,1725,4.8
84950232,6642647133764,Hoa Sen Trên Tuyết (Tái Bản),67000,https://tiki.vn/product-p84950232.html?spid=84950233,98000,31000,32,217,5.0
81224320,2440642905785,Nước Ép Xanh Chữa Lành Cơ Thể,133000,https://tiki.vn/product-p81224320.html?spid=81224322,179000,46000,26,140,4.8
73125816,6195552458721,Digital Marketing - Từ Chiến Lược Đến Thực Thi (Tái Bản 2020),144100,https://tiki.vn/product-p73125816.html?spid=73125817,220000,75900,35,1000,4.8
72689369,5734029699475,Bộ Sách Hạt Giống Tâm Hồn (Trọn Bộ 16 Tập) (Tái Bản Mới Nhất),858000,https://tiki.vn/product-p72689369.html?spid=72689371,1216000,358000,29,183,4.8
58342212,5085821233016,Set 3 cuốn Moi Moi và những người bạn - Dành cho trẻ từ 0-2 tuổi,92500,https://tiki.vn/product-p58342212.html?spid=59395317,117000,24500,21,647,5.0
50685547,2022689106017,Bản Đồ,217350,https://tiki.vn/product-p50685547.html?spid=50685549,345000,127650,37,955,4.8
49181801,1388133553785,Oxford Advanced Learner's Dictionary : Paperback - 10th Edition (With 1 Year's Access To Both Premium Online And App),504000,https://tiki.vn/product-p49181801.html?spid=49181802,590000,86000,15,522,5.0
48753264,6479578034610,Đường Chân Trời Đã Mất (Tái Bản 2019),104000,https://tiki.vn/product-p48753264.html?spid=72454782,120000,16000,13,46,4.3
46240929,8755420465428,Rèn Luyện Tư Duy Phản Biện,89000,https://tiki.vn/product-p46240929.html?spid=260926413,139000,50000,36,0,0.0
10383904,5161286519954,Tôi Là Bêtô,66930,https://tiki.vn/product-p10383904.html?spid=10772070,95000,28070,30,1205,4.8
10325548,2378987394299,How Food Works - Hiểu Hết Về Thức Ăn,195000,https://tiki.vn/product-p10325548.html?spid=10325549,300000,105000,35,678,4.7
8021467,8246382687428,"Combo 4 cuốn: Chuyện con mèo dạy hải âu bay, Chuyện con mèo con chuột và bạn thân của nó, Chuyện con ốc sên, Chuyện chú chó tên là trung thành",115700,https://tiki.vn/product-p8021467.html?spid=127539209,178000,62300,35,50,5.0
706939,2317348322755,The Subtle Art of Not Giving a F*Ck : A Counterintuitive Approach to Living a Good Life,294700,https://tiki.vn/product-p706939.html?spid=21224801,379000,84300,22,227,4.8
509829,2201297792830,Giấy Double A A4 DL70,96000,https://tiki.vn/product-p509829.html?spid=118243645,96000,0,0,19,5.0
276353066,6103551235979,Edogawa Ranpo Tuyển Tập Những Kẻ Sát Nhân Cuồng Loạn,81900,https://tiki.vn/product-p276353066.html?spid=276353071,126000,44100,35,4,4.8
276168127,1587665615676,One Piece Tập 103,22500,https://tiki.vn/product-p276168127.html?spid=276168220,25000,2500,10,6,3.7
275698417,8291199248164,The Light Seer’s Tarot (Bộ Bài & Sách Hướng Dẫn),162500,https://tiki.vn/product-p275698417.html?spid=275698419,250000,87500,35,12,5.0
275296463,6819518889137,Cherry Magic (Tập 11),84600,https://tiki.vn/product-p275296463.html?spid=275297068,109000,24400,22,13,4.5
273552925,6450744804761,Vụ Án Sô Cô La Có Độc,78000,https://tiki.vn/product-p273552925.html?spid=273552927,109000,31000,28,4,5.0
263514100,4690298053475,Liệu Pháp Chữa Bệnh - Khu Phản Xạ,82350,https://tiki.vn/product-p263514100.html?spid=263514101,135000,52650,39,23,4.8
253360429,5402116655829,38 Lá Thư Tỷ Phú John Davison Rockefeller Gửi Cho Con Trai,115340,https://tiki.vn/product-p253360429.html?spid=253360430,158000,42660,27,231,5.0
196849409,9723836913087,"Gửi Em, Người Bất Tử - Tập 11 (Tái Bản 2022)",28000,https://tiki.vn/product-p196849409.html?spid=196849410,30000,2000,7,45,5.0
196849406,3868672493031,"Gửi Em, Người Bất Tử - Tập 9 (Tái Bản 2022)",26100,https://tiki.vn/product-p196849406.html?spid=196849408,30000,3900,13,51,5.0
196849403,9642563932653,"Gửi Em, Người Bất Tử - Tập 8 (Tái Bản 2022)",24100,https://tiki.vn/product-p196849403.html?spid=196849404,30000,5900,20,48,5.0
196001693,2977616649224,Trí Tuệ Của Trái Tim,65900,https://tiki.vn/product-p196001693.html?spid=196001696,88000,22100,25,37,5.0
195190103,9474762085352,Mèo Mốc & Thế Giới Diệu Kỳ Màu Xám,109000,https://tiki.vn/product-p195190103.html?spid=195190104,128000,19000,15,43,5.0
193895767,8638612690338,THE DAILY STOIC – 366 CHIÊM NGHIỆM VỀ TRÍ TUỆ VÀ LÒNG CAN TRƯỜNG CÙNG NGHỆ THUẬT SỐNG,141010,https://tiki.vn/product-p193895767.html?spid=193895768,239000,97990,41,98,4.8
185888686,2227392386414,Trường An Ly Ca 3 – Cao Sơn Lưu Thuỷ,110500,https://tiki.vn/product-p185888686.html?spid=185888687,170000,59500,35,49,4.8
175845415,3254028761797,Bí Quyết Tìm Kiếm Mặt Bằng Kinh Doanh - Đến Sahara Mở Quán Trà Đá - Bộ Sách Khởi Nghiệp Bán Lẻ,162000,https://tiki.vn/product-p175845415.html?spid=175845416,199000,37000,19,169,5.0
171825201,6152359235950,Người Bà Tài Giỏi Vùng Saga – Tập 7,38900,https://tiki.vn/product-p171825201.html?spid=171825202,52000,13100,25,359,4.8
156824943,2228192400670,Mindhunter – Kẻ Săn Suy Nghĩ (Tặng kèm bookmark),109000,https://tiki.vn/product-p156824943.html?spid=156824944,125000,16000,13,201,5.0
152875147,8429841447589,Miền Đất Hứa (A Promised Land) - Barack Obama (Bìa Cứng),179000,https://tiki.vn/product-p152875147.html?spid=152875148,768000,589000,77,452,5.0
148760915,5245813051783,Khách Sạn Mặt Nạ 2 - Đêm Trước Lễ Hội Hóa Trang,106000,https://tiki.vn/product-p148760915.html?spid=214169913,125000,19000,15,0,0.0
126743459,3057249347496,Fear - Sợ Hãi (Hóa Giải Sợ Hãi Bằng Tình Thương),68670,https://tiki.vn/product-p126743459.html?spid=126743460,109000,40330,37,521,5.0
124767712,3274204792178,Không Tự Khinh Bỉ - Không Tự Phí Hoài (Tái Bản),85600,https://tiki.vn/product-p124767712.html?spid=124767713,119000,33400,28,191,5.0
113656455,9182081276551,Giáo Trình Tư Tưởng Hồ Chí Minh (Dành Cho Bậc Đại Học Hệ Không Chuyên Lý Luận Chính Trị) - Bộ mới năm 2021,41000,https://tiki.vn/product-p113656455.html?spid=113656456,45000,4000,9,322,5.0
95997783,8160606103688,Sách Luyện thi B1 Vstep 4 kỹ năng - Ôn thi chứng chỉ tiếng Anh B1 bậc 3 (bằng B1 tiếng Anh) theo Khung NLNN Việt Nam,270000,https://tiki.vn/product-p95997783.html?spid=95997784,300000,30000,10,321,4.8
95090804,4983667953955,Bút dạ viết bảng Deli - xóa được - Mực xanh/đen/đỏ - 1 chiếc – EU00120/ EU00130 / EU00140,7500,https://tiki.vn/product-p95090804.html?spid=95090825,14400,6900,48,261,5.0
87226754,1599886723836,Một Cuốn Sách Buồn… Cười - Vui Vẻ Không Quạu Nha 2,55200,https://tiki.vn/product-p87226754.html?spid=87226757,79000,23800,30,1739,4.8
76014598,8424203802551,Blue Ocean Strategy - Chiến Lược Đại Dương Xanh (Bìa Cứng) (Tái Bản),149040,https://tiki.vn/product-p76014598.html?spid=76014599,239000,89960,38,292,4.8
73316970,3439492947574,Osho - Ươm Mầm,68670,https://tiki.vn/product-p73316970.html?spid=73316971,109000,40330,37,364,5.0
73207240,8787420605399,Xa Ngoài Kia Nơi Loài Tôm Hát - Where The Crawdads Sing,107660,https://tiki.vn/product-p73207240.html?spid=73523598,165000,57340,35,689,5.0
73102465,8905501583101,Bé Tô màu - Combo 11 cuốn,68718,https://tiki.vn/product-p73102465.html?spid=73102466,127255,58537,46,366,4.8
57762732,7316437175994,Nhà Đầu Tư Thông Minh (Tái Bản 2020),129350,https://tiki.vn/product-p57762732.html?spid=57762733,199000,69650,35,2927,4.8
54383647,2094703722381,Fullmetal Alchemist - Cang Giả Kim Thuật Sư - Fullmetal Edition Tập 4,75000,https://tiki.vn/product-p54383647.html?spid=275733672,75000,0,0,0,0.0
53452969,5411648147401,Khởi Nghiệp Du Kích - Kinh Doanh Ít Vốn - Vận Dụng Nguồn Lực Nhỏ Chiến Thắng Cuộc Chơi Lớn (Tái Bản),155000,https://tiki.vn/product-p53452969.html?spid=53452970,199000,44000,22,993,4.8
52329765,7202757631862,Biên Niên Ký Chim Vặn Dây Cót (Tái Bản 2020),129350,https://tiki.vn/product-p52329765.html?spid=52329767,199000,69650,35,638,4.8
40933971,3035316740262,Một Đời Thương Thuyết (Tái Bản),95080,https://tiki.vn/product-p40933971.html?spid=40933972,135000,39920,30,365,5.0
20520720,9562800285731,Đối Thoại Với Thượng Đế ( Tái Bản ),63700,https://tiki.vn/product-p20520720.html?spid=20520721,98000,34300,35,380,4.8
14684952,7574641962827,Khu Vườn Bí Mật ( Tái Bản 2019 ),62400,https://tiki.vn/product-p14684952.html?spid=14684953,96000,33600,35,503,4.8
13446508,9817946733340,Cánh Đồng Bất Tận (Tái Bản 2019),66300,https://tiki.vn/product-p13446508.html?spid=13446509,85000,18700,22,787,5.0
77900446,8672599474922,Thần Số Học: Thấu Hiểu Nhân Tâm,68670,https://tiki.vn/product-p77900446.html?spid=77900447,109000,40330,37,541,4.8
69219921,9187510726727,"OKRs - Hiểu Đúng, Làm Đúng - Cách Để Áp Dụng Thành Công OKRs Ngay Từ Đầu",151430,https://tiki.vn/product-p69219921.html?spid=69219922,239000,87570,37,317,4.8
57350380,6271630401848,Very Easy Toeic 1 - Introduction,172000,https://tiki.vn/product-p57350380.html?spid=57350381,228000,56000,25,235,4.6
54422996,1224421306049,"Nóng Giận Là Bản Năng, Tĩnh Lặng Là Bản Lĩnh (Tái Bản 2020)",68500,https://tiki.vn/product-p54422996.html?spid=54422997,89000,20500,23,92,5.0
19349145,8927700967599,Bí Mật Tư Duy Triệu Phú (Tái Bản 2019),110000,https://tiki.vn/product-p19349145.html?spid=198539590,110000,0,0,4,5.0
12107394,2975785987205,Barron's Essential Words For The Toeic (Tái Bản),158700,https://tiki.vn/product-p12107394.html?spid=12107395,238000,79300,33,917,4.7
3048355,3001101968739,Nhà (Tái Bản),72000,https://tiki.vn/product-p3048355.html?spid=3070291,109000,37000,34,436,4.8
2716247,5232055242462,Quẳng Gánh Lo Đi Và Vui Sống (Bìa Cứng),73900,https://tiki.vn/product-p2716247.html?spid=2716249,108000,34100,32,631,4.8
276051689,4982049656208,Muốn Phi Thăng Thì Yêu Đi (Tập 4),166000,https://tiki.vn/product-p276051689.html?spid=276051807,189000,23000,12,3,4.7
275821937,1914806389289,"Không Sợ Thất Bại, Chỉ Sợ Bạn Nuông Chiều Bản Thân Chưa Nỗ Lực Hết Mình",101000,https://tiki.vn/product-p275821937.html?spid=275923478,119000,18000,15,0,0.0
275576876,5447090901451,Agatha Christie. Vụ án mạng được báo trước - Một vụ án của Jane Marple,105000,https://tiki.vn/product-p275576876.html?spid=275576880,150000,45000,30,17,5.0
273910316,8378081977206,Chính Sách Tiền Tệ Thế Kỷ 21,221800,https://tiki.vn/product-p273910316.html?spid=273910317,325000,103200,32,73,5.0
260811341,3512353272812,Bài tập Bổ trợ Tiếng Anh 4 i-Learn Smart Start,80000,https://tiki.vn/product-p260811341.html?spid=260811342,89000,9000,10,12,5.0
197602047,7503604771030,Fullmetal Alchemist - Cang Giả Kim Thuật Sư - Fullmetal Edition Tập 9,75000,https://tiki.vn/product-p197602047.html?spid=275733682,75000,0,0,0,0.0
195306000,1894605490579,Tư trị thông giám - Tập 9,208000,https://tiki.vn/product-p195306000.html?spid=195306002,285000,77000,27,49,5.0
193988321,6936866283291,Đứng Vững Trong Đơn Độc,72100,https://tiki.vn/product-p193988321.html?spid=193988322,96000,23900,25,23,4.7
193981038,4390465677686,Vua sáng chế - Tập 15,19500,https://tiki.vn/product-p193981038.html?spid=193981039,20000,500,3,37,5.0
193605374,5928468557799,Làm Sao Để Che Giấu Một Đế Quốc - How To Hide An Empire,194350,https://tiki.vn/product-p193605374.html?spid=193605375,299000,104650,35,32,5.0
191506179,5948693883969,Sách Bạn Thật Sự Là Ai?,58600,https://tiki.vn/product-p191506179.html?spid=191506180,88000,29400,33,42,4.8
190242074,6528671005851,Chuông Gió (Tập 1) - Tặng kèm 1 bookmark,122000,https://tiki.vn/product-p190242074.html?spid=190242075,174000,52000,30,160,5.0
189657596,2903364292807,Komi - Nữ Thần Sợ Giao Tiếp Tập 11,24300,https://tiki.vn/product-p189657596.html?spid=189657597,25000,700,3,102,5.0
188940825,1501634631405,Những Chàng Trai Ở Lộc Phong Quán – Tập 10 - Tặng 1 bookmark 2 mặt ,38300,https://tiki.vn/product-p188940825.html?spid=188940826,48000,9700,20,92,5.0
186434891,1558567867800,Cá Cược Với Tình Yêu,53000,https://tiki.vn/product-p186434891.html?spid=186434892,95000,42000,44,11,5.0
186434701,2437031705211,"Khi Bạn Đang Say Giấc, Ai Đó Đã Đạt Được Ước Mơ-Tặng kèm 01 bookmark",75500,https://tiki.vn/product-p186434701.html?spid=186434703,108000,32500,30,177,4.8
177637709,7418843715930,Làm Chủ Bình Minh - Sống Đời Xuất Chúng - CLB 5 Giờ Sáng (Robin Sharma),115000,https://tiki.vn/product-p177637709.html?spid=58444775,185000,70000,38,150,5.0
173093792,3402913972782,"Thao Túng Tâm Lý - Nhận Diện, Thức Tỉnh Và Chữa Lành Những Tổn Thương Tiềm Ẩn",123300,https://tiki.vn/product-p173093792.html?spid=173093793,169000,45700,27,20,5.0
171170802,3578669872111,Kỹ thuật giao dịch nâng cao để kiếm tiền hàng ngày trên thị trường chứng khoán – Advanced Techniques in Day Trading,359000,https://tiki.vn/product-p171170802.html?spid=171170811,359000,0,0,86,4.8
142002263,7807886637946,Muôn Kiếp Nhân Sinh 2 (Bìa Cứng),338000,https://tiki.vn/product-p142002263.html?spid=142002265,338000,0,0,380,5.0
135754581,2327596156485,Những Câu Chuyện Truyền Cảm Hứng - I Will Be Better: Nguồn Năng Lượng Tích Cực,50500,https://tiki.vn/product-p135754581.html?spid=135754582,58000,7500,13,38,5.0
117035933,6998898578292,Sách: Hài Hước Một Chút Thế Giới Sẽ Khác Đi (Tái Bản),72000,https://tiki.vn/product-p117035933.html?spid=117035934,80000,8000,10,142,4.8
113583126,4526483417578,Ngữ Pháp Tiếng Anh (Tái Bản),75000,https://tiki.vn/product-p113583126.html?spid=272947486,89000,14000,16,0,0.0
111580006,5735200183510,Sách Muôn Kiếp Nhân Sinh 2 (Khổ Nhỏ) - Nguyên Phong,112000,https://tiki.vn/product-p111580006.html?spid=111580007,148000,36000,24,1093,5.0
109018530,8631988385379,Vườn Hoa Mạt Dược Ký Sự - Những Kỳ Án Nổi Tiếng Chưa Có Lời Giải (Tặng Kèm 1 Bookmark Chữ Nhật),98900,https://tiki.vn/product-p109018530.html?spid=109018531,139000,40100,29,683,4.8
107342987,2066930576560,Bút bi nước khô nhanh Deli - 0.5mm - Bút viết thư pháp - Ống bút liền mực - Mực Xanh/ Đen/ Đỏ - 1 chiếc - S856,7000,https://tiki.vn/product-p107342987.html?spid=107342989,12600,5600,44,467,4.8
105663942,6770998096816,Hành Trình Về Phương Đông (Tái Bản 2021),80000,https://tiki.vn/product-p105663942.html?spid=127538916,118000,38000,32,490,5.0
95090377,1071260690747, Bút màu sáp dầu học sinh hộp nhựa Deli - 12/18/24 màu - 72090/72091/72092,32000,https://tiki.vn/product-p95090377.html?spid=95090465,57600,25600,44,297,4.5
90227346,1004300191523,Sapiens: Lược Sử Loài Người Bằng Tranh - Tập 1: Khởi Đầu Của Loài Người,216650,https://tiki.vn/product-p90227346.html?spid=90643155,345000,128350,37,693,5.0
88914965,5982839241068,Nam Châm Gắn Bảng 15Mm Deli - 1 Vỉ - E7823,16000,https://tiki.vn/product-p88914965.html?spid=88914966,30600,14600,48,40,4.6
87389629,2863187010105,OSHO - Sáng Tạo Bừng Cháy Sức Mạnh Bên Trong (Tái Bản),74600,https://tiki.vn/product-p87389629.html?spid=87389630,108000,33400,31,115,5.0
77324132,2118318697570,Phụ Nữ Hiểu Biết Sẽ Có Cuộc Sống Đẳng Cấp Hơn (Tặng Kèm Bookmark),85600,https://tiki.vn/product-p77324132.html?spid=77324133,119000,33400,28,656,5.0
75813201,8964372567955,Không Đến Một (Tái Bản - Bìa Cam),99000,https://tiki.vn/product-p75813201.html?spid=253119474,110000,11000,10,0,0.0
68392386,6734730563200,Stephen Hawking - Trả Lời Ngắn Gọn Những Câu Hỏi Lớn,63940,https://tiki.vn/product-p68392386.html?spid=68392388,90000,26060,29,295,5.0
58441509,7191137454675,Ăn Uống Đúng Cách: Bộ Quy Tắc Ẩm Thực Lành Mạnh,75400,https://tiki.vn/product-p58441509.html?spid=58441510,116000,40600,35,493,4.7
58390336,3380735508079,Python cơ bản,118750,https://tiki.vn/product-p58390336.html?spid=58390337,125000,6250,5,902,4.8
56878836,1770468875180,Sách Muôn Kiếp Nhân Sinh (Bìa Cứng) - Nguyên Phong,172000,https://tiki.vn/product-p56878836.html?spid=56878837,228000,56000,25,1764,5.0
26593338,6110133572337,Misty Morning Walk With Mother - Cùng Mẹ Đi Trong Sương Sớm,43600,https://tiki.vn/product-p26593338.html?spid=52240372,54500,10900,20,41,5.0
13673970,9193762060908,Combo Trinh Thám Giây Thứ 12 (2 Tập),136000,https://tiki.vn/product-p13673970.html?spid=52156510,170000,34000,20,66,5.0
8886005,9992672955058,Bay Trên Tổ Chim Cúc Cu (Tái Bản),76700,https://tiki.vn/product-p8886005.html?spid=8886006,118000,41300,35,302,4.8
276286317,1996035917368,Sổ Tay Triết Học,119000,https://tiki.vn/product-p276286317.html?spid=276286321,149000,30000,20,2,5.0
275967018,1305427897752,Hot Boy Miền Quê – Tập 1,77300,https://tiki.vn/product-p275967018.html?spid=275967228,88000,10700,12,7,5.0
275853508,9363996609485,Khởi Nguyên Của Vũ Trụ: Lịch Sử 14 Tỉ Năm Tiến Hóa,143350,https://tiki.vn/product-p275853508.html?spid=275853513,235000,91650,39,5,4.8
274919182,7601831554852,Siêu án mạng: nỗi ưu phiền của các nhà văn trinh thám,84500,https://tiki.vn/product-p274919182.html?spid=274919183,130000,45500,35,12,5.0
274554761,3562596816107,Kẻ Xa Lạ,120000,https://tiki.vn/product-p274554761.html?spid=274554766,165000,45000,27,2,3.5
272003238,4106907911034,Nụ hôn tinh nghịch,79500,https://tiki.vn/product-p272003238.html?spid=273315952,90000,10500,12,28,5.0
260811369,2250549599512,Tiếng Anh 8 i-Learn Smart World Workbook,70000,https://tiki.vn/product-p260811369.html?spid=260811370,70000,0,0,9,5.0
206840682,9725373677700,Quyền Lực Của Địa Lý - The Power Of Geography,182000,https://tiki.vn/product-p206840682.html?spid=206840683,280000,98000,35,377,5.0
197629362,4304350204896,Bức Họa Múa Rối Xương (Combo tập 1+2),210000,https://tiki.vn/product-p197629362.html?spid=197629366,279000,69000,25,340,5.0
192125806,8685948240690,Dạy con làm giàu - Tập 11 - Trường dạy kinh doanh cho những người thích giúp đỡ người khác (Tái Bản 2022),60800,https://tiki.vn/product-p192125806.html?spid=192125807,80000,19200,24,50,5.0
190701636,3270861434854,Yuri Espoir (Tập 2),39000,https://tiki.vn/product-p190701636.html?spid=190701642,79000,40000,51,218,5.0
190214568,7024118946484,Kỷ luật bản thân,160650,https://tiki.vn/product-p190214568.html?spid=262707073,189000,28350,15,0,0.0
178483666,6136747230598,Những Lời Giáo Huấn Của Epictetus,150570,https://tiki.vn/product-p178483666.html?spid=178483668,239000,88430,37,132,4.8
174444163,8940996830246,"Dear, Darling",63300,https://tiki.vn/product-p174444163.html?spid=174444165,88000,24700,28,897,4.8
146988856,2908381353130,Lựa Chọn Đúng Quan Trọng Hơn Nỗ Lực - 6 Bước Để Ra Quyết Định Hoàn Hảo,110300,https://tiki.vn/product-p146988856.html?spid=146988861,170000,59700,35,117,4.8
146225297,2691409825279,Flow - Dòng Chảy,162000,https://tiki.vn/product-p146225297.html?spid=146225298,228000,66000,29,128,5.0
143226165,8280311570015,Cẩm Nang Khám Phá Cơ Thể Người (Tặng Kèm Bookmark),57600,https://tiki.vn/product-p143226165.html?spid=143226167,78000,20400,26,237,4.8
142791749,2858137096395,Sự Trỗi Dạy Và Suy Tàn Của Đế Chế Thứ 3 (Tái Bản),321000,https://tiki.vn/product-p142791749.html?spid=142791755,445000,124000,28,176,4.6
137241842,8389146988449,Trồng Một Nụ Cười - Cùng Trẻ Thực Hành Chánh Niệm,125370,https://tiki.vn/product-p137241842.html?spid=137241848,199000,73630,37,192,5.0
135552451,8984896242706,Các Triều Đại Việt Nam,77000,https://tiki.vn/product-p135552451.html?spid=135552452,120000,43000,36,135,5.0
130314065,3875596685825,Tâm lý thị trường chứng khoán - Hành vi đám đông và sự thật đằng sau những con sóng,25000,https://tiki.vn/product-p130314065.html?spid=132834192,50000,25000,50,74,5.0
126853168,8709694643733,Thấu hiểu Hành vi giá Thị trường Tài chính (Understanding Price Action),367000,https://tiki.vn/product-p126853168.html?spid=126853169,367000,0,0,284,5.0
117681065,7628569475010,Sống Thực Tế Giữa Đời Thực Dụng (Tái Bản),77400,https://tiki.vn/product-p117681065.html?spid=117681066,129000,51600,40,503,4.8
116835635,7962215728507,Tớ Học Lập Trình - Làm Quen Với Python,68250,https://tiki.vn/product-p116835635.html?spid=116835636,105000,36750,35,158,5.0
113655308,6293122317958,Giáo Trình Kinh Tế Chính Trị Mác – Lênin (Dành Cho Bậc Đại Học Hệ Không Chuyên Lý Luận Chính Trị) - Bộ mới năm 2021,46000,https://tiki.vn/product-p113655308.html?spid=113655309,48000,2000,4,413,5.0
107363748,8736478925337,Bút chì màu dạng cốc Deli - bút chì gỗ khô tự nhiên an toàn -  12/24/36/48 màu - 7070,95000,https://tiki.vn/product-p107363748.html?spid=107363756,171000,76000,44,209,4.8
106788395,3452950381278,Toán Tư duy - Beginning Creative Math (Dành cho bé 4-6 tuổi/Song ngữ Việt - Anh),57200,https://tiki.vn/product-p106788395.html?spid=106788396,110000,52800,48,196,4.8
100947274,8402714308823,Tìm Bình Yên Trong Gia Đình (Tái Bản),62370,https://tiki.vn/product-p100947274.html?spid=100947275,99000,36630,37,191,5.0
95311757,3493324846297,Lưu Thông Máu Tốt Hóa Giải Bách Bệnh,64350,https://tiki.vn/product-p95311757.html?spid=95311758,99000,34650,35,241,5.0
95090744,4199666698567, Bút chì lục giác Deli - loại 2B/HB - 30 chiếc/hộp - 58166 / 58167,60000,https://tiki.vn/product-p95090744.html?spid=95090786,108000,48000,44,200,4.8
94173462,3047171576270,Muôn Kiếp Nhân Sinh 2,175600,https://tiki.vn/product-p94173462.html?spid=94173463,268000,92400,34,5748,5.0
83004183,3777153859172,Nhóc Miko! Cô Bé Nhí Nhảnh 34,25000,https://tiki.vn/product-p83004183.html?spid=83004184,25000,0,0,546,5.0
75403873,3693555365211,"Bộ Màu Nước Solid Water Color Cao Cấp - Tặng Kèm 2 Bút Nước, 2 Mút, 1 Palette - Chuyên Dùng Cho Học Sinh, Sinh Viên, Vẽ Chuyên Nghiệp - Hàng Chính Hãng - VinBuy",95000,https://tiki.vn/product-p75403873.html?spid=75403875,120000,25000,21,514,4.8
49249526,7679423483917,Thiết Kế Cuộc Đời Thịnh Vượng - Design a Prosperous Life,299000,https://tiki.vn/product-p49249526.html?spid=49249529,299000,0,0,2889,5.0
41131985,5023462929066,Thực Hành 7 Thói Quen Của Bạn Trẻ Thành Đạt,60100,https://tiki.vn/product-p41131985.html?spid=41131986,78000,17900,23,223,4.7
37865684,9291499563454,Fullmetal Alchemist - Cang Giả Kim Thuật Sư - Fullmetal Edition Tập 1,75000,https://tiki.vn/product-p37865684.html?spid=275733542,75000,0,0,0,0.0
23433003,1462325562059,30 Chủ Đề Từ Vựng Tiếng Anh (Tập 1),121000,https://tiki.vn/product-p23433003.html?spid=28296432,190000,69000,36,1204,5.0
22986051,7159030183566,Atomic Habits,395200,https://tiki.vn/product-p22986051.html?spid=22986052,479000,83800,17,156,5.0
4466841,5091634338329,Trưởng Thành Sau Ngàn Lần Tranh Đấu (Tái Bản),61750,https://tiki.vn/product-p4466841.html?spid=4466843,95000,33250,35,653,4.7
1445365,9351974982221,Dưới Một Mái Nhà Ở Paris,77350,https://tiki.vn/product-p1445365.html?spid=1449791,119000,41650,35,491,4.8
276246253,6140027380458,Tiếng Việt Ân Tình - Tập 2,112770,https://tiki.vn/product-p276246253.html?spid=276246254,179000,66230,37,0,0.0
275698431,6113360091626,Công Lý Tuyệt Đối,95400,https://tiki.vn/product-p275698431.html?spid=275699329,129000,33600,26,1,5.0
275104697,5183137437320,Bộ sách Thắc mắc khoa học. STEM,27100,https://tiki.vn/product-p275104697.html?spid=275104806,30000,2900,10,0,0.0
275044457,6015106185494,38 lá thư Rockefeller gửi cho con trai,111800,https://tiki.vn/product-p275044457.html?spid=275044458,158000,46200,29,14,5.0
273621275,2460001548286,Agatha Christie. Bi kịch ba hồi,88490,https://tiki.vn/product-p273621275.html?spid=273621277,125000,36510,29,31,5.0
273165484,4778567466657,Vòm Rừng (Tái Bản 2023),201000,https://tiki.vn/product-p273165484.html?spid=273165485,279000,78000,28,11,5.0
270835318,2103971694234,7 Chiến Lược Để Sống Sung Túc & Hạnh Phúc,66500,https://tiki.vn/product-p270835318.html?spid=270835319,98000,31500,32,5,5.0
262590359,1989086211064,Hoàng Tử Bé,20300,https://tiki.vn/product-p262590359.html?spid=262590362,35000,14700,42,294,5.0
242770600,9998553225553,Người Bà Tài Giỏi Vùng SaGa - Tập 10,39000,https://tiki.vn/product-p242770600.html?spid=242770601,52000,13000,25,89,4.7
204051994,6540740614314,Ngôi nhà kỳ quái,88000,https://tiki.vn/product-p204051994.html?spid=204051995,138000,50000,36,164,5.0
194471830,8916179174582,We Best Love - Mãi Mãi Là Số 1 & Cuộc Phản Công Của Số 2 [Tặng Kèm Bookmark + Postcard + Bìa Bao Giả Lập Poster + Giá Đỡ Điện Thoại],180000,https://tiki.vn/product-p194471830.html?spid=270111579,180000,0,0,0,0.0
193099631,2266299131030,Đại Gia Gatsby,55900,https://tiki.vn/product-p193099631.html?spid=193099632,86000,30100,35,88,4.8
192692368,7168705650316,Phương Pháp Thực Chiến Hiệu Suất Cao Đến Từ Nhà Quán Quân Giao Dịch Tài Chính,364000,https://tiki.vn/product-p192692368.html?spid=192692369,364000,0,0,45,4.8
192474352,7092650519012,Vẻ Đẹp Của Sự Vừa Đủ,95100,https://tiki.vn/product-p192474352.html?spid=192474353,136000,40900,30,35,4.8
189558192,6586701671579,Dr.SLUMP Ultimate Edition - Tập 11,54100,https://tiki.vn/product-p189558192.html?spid=189558193,60000,5900,10,52,4.8
188039858,4672447937128,"Combo 4 Cuốn Sổ Tay Ghi Chép A5 Gáy Xoắn 120 Trang Kẻ Ngang Deli - Phù Hợp Làm Sổ Kế Hoạch Planner, Nhật Kí, Tập Vở Ghi Chép Bullet Journal - LA560-06",20000,https://tiki.vn/product-p188039858.html?spid=188039860,37800,17800,47,105,4.7
187843292,1040237667945,Hoa trên mộ Algernon,97500,https://tiki.vn/product-p187843292.html?spid=187843294,150000,52500,35,72,4.8
187827443,2268890187613,Ăn Gì Không Chết - Sức Mạnh Chữa Lành Của Thực Phẩm,203800,https://tiki.vn/product-p187827443.html?spid=187827444,320000,116200,36,35,4.8
187827390,6423052487567,Gửi Tới Người Mùa Đông Này Sẽ Không Còn Nữa,88500,https://tiki.vn/product-p187827390.html?spid=187827391,123000,34500,28,106,5.0
185909452,2306851782169,Điệp Viên Hoàn Hảo X6 (Bìa Mềm),121800,https://tiki.vn/product-p185909452.html?spid=185909453,178000,56200,32,80,5.0
181699672,1606818954284,Shuggie Bain: Chiếc Linh Hồn Nhỏ,150000,https://tiki.vn/product-p181699672.html?spid=181699673,235000,85000,36,83,5.0
162832796,8690703075544,Rilla Dưới Mái Nhà Bên Ánh Lửa,170000,https://tiki.vn/product-p162832796.html?spid=188553980,200000,30000,15,0,0.0
136232535,5415579609656,"Ux Content 4.0 (Chọn Đúng Chữ, Giữ Người Dùng)",125000,https://tiki.vn/product-p136232535.html?spid=199648738,139000,14000,10,0,0.0
106149744,7267763456198,Tôi Đã Kiếm 2.000.000 Đô La Từ Thị Trường Chứng Khoán Như Thế Nào (Tái Bản),81650,https://tiki.vn/product-p106149744.html?spid=160308364,109000,27350,25,2,5.0
105778970,8754232766138,Nhật Ký Tarot,129000,https://tiki.vn/product-p105778970.html?spid=105778971,199000,70000,35,317,5.0
94173458,2880741770352,Khuyến Học (Tái Bản),59000,https://tiki.vn/product-p94173458.html?spid=199166017,65000,6000,9,0,0.0
83664156,8660753980616,"Rio Book No.2 - Nhận Diện Thương Hiệu, Những Điểm Chạm Thị Giác (Tái Bản)",136000,https://tiki.vn/product-p83664156.html?spid=83664157,170000,34000,20,237,4.8
77149524,1229593904571,Range - Hiểu Sâu Biết Rộng Kiểu Gì Cũng Thắng,149000,https://tiki.vn/product-p77149524.html?spid=274418157,199000,50000,25,26,5.0
66067655,1492781161879,Trải Nghiệm Khách Hàng Xuất Sắc,175500,https://tiki.vn/product-p66067655.html?spid=66067656,250000,74500,30,940,5.0
57590002,1669999082627,Fullmetal Alchemist - Cang Giả Kim Thuật Sư - Fullmetal Edition Tập 5,66900,https://tiki.vn/product-p57590002.html?spid=58718372,69000,2100,3,31,5.0
56750844,5633537038717,Tiểu Sử Steve Jobs (Tái Bản 2020),280910,https://tiki.vn/product-p56750844.html?spid=56750845,449000,168090,37,341,4.8
56377199,3729170174096,Giải Mã Siêu Trí Tuệ,121000,https://tiki.vn/product-p56377199.html?spid=58210464,169000,48000,28,57,4.7
127203905,3531357542670,Băng Keo Dán Băng Dính 2 Mặt Nano Trong Suốt Đa Năng Siêu Dính Chống Nước Deli - Nhiều Kích Cỡ,23000,https://tiki.vn/product-p127203905.html?spid=201375819,45000,22000,49,234,4.7
127077157,2818881819289,Bà Tổng Thống Trước Họng Súng - Hai Số Phận - Phần III,122000,https://tiki.vn/product-p127077157.html?spid=127077158,199000,77000,39,211,4.7
121185868,1706587506310,Vang Bóng Một Thời (Việt Nam Danh Tác),49400,https://tiki.vn/product-p121185868.html?spid=121185871,76000,26600,35,231,4.8
114765005,2214804934023,Vụng Trộm Yêu Anh - Tập 1+2 (Tặng Kèm: 02 Bookmark 2 Mặt Theo Bìa),179000,https://tiki.vn/product-p114765005.html?spid=114765006,249000,70000,28,505,4.8
110583137,3447050889289,Bút highlight nhấn dòng dạ quang Deli - Cam/ Vàng/ Xanh Lá/ Hồng/ Xanh Dương - S625,5600,https://tiki.vn/product-p110583137.html?spid=110583196,10620,5020,47,354,5.0
104273017,6880555779906,Combo 2 Tập: Tăng Thông Khí,219000,https://tiki.vn/product-p104273017.html?spid=104273019,258000,39000,15,1592,4.8
84950236,2087583927478,Người Nhạy Cảm Trong Thế Giới Vô Cảm,53550,https://tiki.vn/product-p84950236.html?spid=84950237,85000,31450,37,232,4.8
75636226,5555910787404,Phương pháp VPA - Kỹ thuật nhận diện Dòng Tiền Thông Minh bằng Hành Động Giá kết hợp Khối Lượng Giao Dịch,357000,https://tiki.vn/product-p75636226.html?spid=75636227,357000,0,0,1005,4.8
74981856,8052549650842,"Gửi Bạn, Người Đã Kiệt Sức Vì Những Chịu Đựng Âm Thầm [Tặng Kèm: 1 Bookmark Daisy]",67100,https://tiki.vn/product-p74981856.html?spid=74981857,96000,28900,30,711,5.0
74608742,9088094332802,Vừa Đủ - Đẳng Cấp Sống Của Người Thụy Điển (Tái Bản),75500,https://tiki.vn/product-p74608742.html?spid=74608744,98000,22500,23,81,5.0
69624539,5964878169342,Khoa Học Về Yoga,195000,https://tiki.vn/product-p69624539.html?spid=69624541,300000,105000,35,402,4.8
28292286,7323600871836,Combo 30 Chủ Đề Từ Vựng Tiếng Anh (2 Tập),380000,https://tiki.vn/product-p28292286.html?spid=53111746,380000,0,0,9,5.0
16448936,9908233563907,Hộp 10 bút lông bảng Thiên Long FO-WB015,70000,https://tiki.vn/product-p16448936.html?spid=62366445,70000,0,0,21,4.8
7644510,5281556941718,Lòng Tốt Của Bạn Cần Thêm Đôi Phần Sắc Sảo,88600,https://tiki.vn/product-p7644510.html?spid=7644511,108000,19400,18,629,4.6
447164,2561986156115,Tôi Vẽ - Phương Pháp Tự Học Vẽ Truyện Tranh,71000,https://tiki.vn/product-p447164.html?spid=153902,100000,29000,29,999,4.8
276451415,6352539266079,Kỷ Luật Mềm Trong Gia Đình: Giáo Dục Trẻ 3 - 10 Tuổi Dành Cho Gia Đình Việt,105600,https://tiki.vn/product-p276451415.html?spid=115897819,120000,14400,12,93,5.0
276361295,4552965724901,Lang Gia Bảng (Tập 3),132000,https://tiki.vn/product-p276361295.html?spid=276361377,155000,23000,15,2,5.0
275909699,2825592533672,Bắt Đầu Với Câu Hỏi Tại Sao - Nghệ Thuật Truyền Cảm Hứng Trong Kinh Doanh,83850,https://tiki.vn/product-p275909699.html?spid=275909706,129000,45150,35,491,4.8
275452238,9865513080199,Cốt Toái,70850,https://tiki.vn/product-p275452238.html?spid=275452239,109000,38150,35,5,5.0
273645890,4184236720067,Trạm Đọc | Thuật Tẩy Não,140900,https://tiki.vn/product-p273645890.html?spid=275099367,189000,48100,25,0,0.0
273333606,4214991566549,Bí Mật Kiếm Tiền Từ Video Ngắn - Để Tạo Nên 6 Nguồn Thu Nhập Từ Thương Hiệu Cá Nhân,199000,https://tiki.vn/product-p273333606.html?spid=273333607,250000,51000,20,11,4.6
216090597,8146056172561,Thao Túng Tâm Lý Trong Giao Tiếp,104780,https://tiki.vn/product-p216090597.html?spid=216090598,169000,64220,38,20,5.0
200935032,8011487256587,"Màu Acrylic 100ml Cao Cấp Dạng Hũ Finenolo Deli - Tô Đất Sét, Đất Nặn Tự Khô, Vẽ Túi Vải Tote, Quần Áo DIY, Giày, Tranh Tường, Đa Chất Liệu, Tươi Sáng, Nhanh Khô - Nhiều Màu Sắc",17000,https://tiki.vn/product-p200935032.html?spid=200935052,33840,16840,50,100,5.0
189940724,9264213566264,Triệu Phú Khu Ổ Chuột,81900,https://tiki.vn/product-p189940724.html?spid=189940725,126000,44100,35,94,5.0
188694727,5179273602028,Tập viết tiếng Thái,36000,https://tiki.vn/product-p188694727.html?spid=188694728,50000,14000,28,27,5.0
188536931,1671068656989,Gửi Người Bí Ẩn Thân Thương (Truyện Tranh),92700,https://tiki.vn/product-p188536931.html?spid=188536932,109000,16300,15,81,5.0
187827394,1913039900652,LÀM CHỦ VẬN MAY - 8 Bí Quyết Thay Đổi Vận Mệnh,76300,https://tiki.vn/product-p187827394.html?spid=187827395,109000,32700,30,17,5.0
186290824,4808935464986,Hạ đỏ (Tái Bản 2022),31600,https://tiki.vn/product-p186290824.html?spid=186290825,38000,6400,17,79,5.0
185410021,1027575806716,Set Decal Bọc Sách Vở Dán Bìa Trong Suốt Chống Nước Nhiều Kích Cỡ Deli - Bọc SGK Vở Sổ Tay Ghi Chép Truyện Tiều Thuyết - Lưu Trữ Bền Đẹp - 70603 / 70602 / 70601,21000,https://tiki.vn/product-p185410021.html?spid=185410027,39600,18600,47,94,4.7
181379111,7519064790345,Vô Cùng Tàn Nhẫn Vô Cùng Yêu Thương Tập 4,95440,https://tiki.vn/product-p181379111.html?spid=181379112,149000,53560,36,12,5.0
160488838,2919394212531,Axit Và Kiềm Trong Thực Dưỡng (Tái Bản),48750,https://tiki.vn/product-p160488838.html?spid=160488839,75000,26250,35,113,5.0
160081248,3333764556880,Gấu Pooh Xinh Xắn,58500,https://tiki.vn/product-p160081248.html?spid=160081249,90000,31500,35,89,5.0
157432540,3259212704515,Thư Tình Gửi Một Người (Trịnh Công Sơn) (Tái Bản),137600,https://tiki.vn/product-p157432540.html?spid=157432541,195000,57400,29,170,5.0
150709654,1977110697397,i-Learn English for Math 2 Student's book 2nd edition,99000,https://tiki.vn/product-p150709654.html?spid=150709655,99000,0,0,0,0.0
149942445,8730898390474,Sức Mạnh Thương Mại Điện Tử - 12 Tháng Kiếm 1 Triệu Đô Bằng Kinh Doanh Online - Bộ Sách Trên Lưng Khổng Tượng,143000,https://tiki.vn/product-p149942445.html?spid=149942446,199000,56000,28,128,5.0
143226162,2498734020813,Tỷ Phú Bán Giày (Tái Bản),104040,https://tiki.vn/product-p143226162.html?spid=143226164,159000,54960,35,117,4.8
141483251,8070577886994,Sách: Thai Giáo Theo Chuyên Gia - 280 Ngày Mỗi Ngày Đọc 1 Trang (Tái Bản),97750,https://tiki.vn/product-p141483251.html?spid=141483252,115000,17250,15,77,5.0
139979522,6945523479326,Ăn Dặm Kiểu Nhật (Tái Bản),122850,https://tiki.vn/product-p139979522.html?spid=139979523,189000,66150,35,177,5.0
138269668,6101730794626,Từ Điển Tiếng Việt (Hoàng Phê)(Tái Bản),437000,https://tiki.vn/product-p138269668.html?spid=138269670,495000,58000,12,258,4.8
137751490,8753098819343,"Bảng từ trắng treo tường viết bút lông Deli Nhiều kích cỡ - Dùng Cho Văn Phòng, Trường Học, Tập Vẽ, Ghi Chú Công Thức Nấu Ăn, Trang Trí Nhà Cửa",239000,https://tiki.vn/product-p137751490.html?spid=137751492,430200,191200,44,169,4.5
132355750,6260697047317,Võ Nguyên Giáp - Hào Khí Trăm Năm (Tái Bản),180000,https://tiki.vn/product-p132355750.html?spid=273454957,200000,20000,10,1,5.0
127654481,1535798488983,Tiệm Café Bên Rìa Thế Giới,69000,https://tiki.vn/product-p127654481.html?spid=127654484,108000,39000,36,81,5.0
109505434,7564739312098,Bạn Không Thông Minh Lắm Đâu (Tái Bản)(Tặng kèm Bookmark),103000,https://tiki.vn/product-p109505434.html?spid=109505435,139000,36000,26,661,4.8
107409418,9234135900558,Tiếng Anh 6 I-Learn Smart World - Student'S Book (Sách Học Sinh),78000,https://tiki.vn/product-p107409418.html?spid=107409419,78000,0,0,93,5.0
97825967,6757032374142,Tuyển Tập Những Câu Chuyện Hay Nhất Của AESOP (Song Ngữ Anh - Việt),70400,https://tiki.vn/product-p97825967.html?spid=101262159,88000,17600,20,7,4.7
96366365,2132313784394,Bức Tranh Dorian Gray (The Picture Of Dorian Gray),122000,https://tiki.vn/product-p96366365.html?spid=96366366,169000,47000,28,98,5.0
87960389,7029135156315,Keo Siêu Dính Đa Năng Deli - 7Ml/ 20Ml - 7140/7149,20000,https://tiki.vn/product-p87960389.html?spid=121088229,36000,16000,44,262,4.6
73810559,9280181697157,Combo 3 Cuốn: Hiệu Ứng Chim Mồi Tập 1 + 2 + 3,165000,https://tiki.vn/product-p73810559.html?spid=263499172,265000,100000,38,2,5.0
71880692,7721732247404,"600 Câu Hỏi Dùng Cho Sát Hạch, Cấp Giấy Phép Lái Xe Cơ Giới Đường Bộ",43000,https://tiki.vn/product-p71880692.html?spid=71880693,45000,2000,4,273,4.8
31509726,6664030992090,Làm Bạn Với Bầu Trời (Bìa Mềm) (Tặng Kèm Khung Ảnh Số Lượng Có Hạn),76160,https://tiki.vn/product-p31509726.html?spid=31509727,110000,33840,31,2166,5.0
26272210,4204507408291,"Mọi người đều nói dối - Dữ liệu lớn, Dữ liệu mới và những điều Internet tiết lộ về chính chúng ta",75000,https://tiki.vn/product-p26272210.html?spid=42131412,150000,75000,50,290,4.7
16391543,1535036542846,Cha Voi - Dạy Con Nên Người Ở Thời Đại Số,116000,https://tiki.vn/product-p16391543.html?spid=16391544,150000,34000,23,292,5.0
11347711,9606143042276,All The Rule - Sống Bản Lĩnh Theo Cách Một Quý Cô,67300,https://tiki.vn/product-p11347711.html?spid=11347712,96000,28700,30,483,4.7
7369223,8494814360139,Cho Tôi Xin Một Vé Đi Tuổi Thơ (Bìa Mềm) (Tái Bản),68100,https://tiki.vn/product-p7369223.html?spid=7369225,90000,21900,24,1688,4.8
6915413,5073487500054,"Nghệ Thuật Tối Giản: Có Ít Đi, Sống Nhiều Hơn (Tái bản)",73500,https://tiki.vn/product-p6915413.html?spid=6915415,108000,34500,32,214,4.8
276093671,1799941209266,"Sách Công Thức Nhân Sự ""3 TẦNG"" Doanh Nghiệp Tinh Gọn - Sếp Nhẹ Đầu",149000,https://tiki.vn/product-p276093671.html?spid=276093672,200000,51000,26,3,4.7
276078455,7374509097697,Series các tập Gachiakuta,40500,https://tiki.vn/product-p276078455.html?spid=276285591,40500,0,0,3,5.0
275946551,5275868472392,Hirayasumi – Những Tháng Ngày Chơi Vơi (Tập 1),41000,https://tiki.vn/product-p275946551.html?spid=275947062,68000,27000,40,8,5.0
275782190,6792211617439,Nuôi Dạy Trẻ Mắc Hội Chứng Rối Loạn Tăng Động Giảm Chú Ý (ADHD),88960,https://tiki.vn/product-p275782190.html?spid=275782193,139000,50040,36,2,5.0
274145052,4988645899594,Trạm Đọc| Hackers IELTS Basic: Reading + Writing + Speaking + Listening ( Dành cho người mới bắt đầu ),141000,https://tiki.vn/product-p274145052.html?spid=275862993,189000,48000,25,0,0.0
273869078,7311735982794,Edogawa Ranpo Tuyển Tập - Những Tội Ác Bất Dung Thứ,72300,https://tiki.vn/product-p273869078.html?spid=273869079,99000,26700,27,6,4.8
262797660,2590566759762,Chó sủa nhầm cây - Tại sao những gì ta biết về thành công có khi lại sai (Tái bản),90000,https://tiki.vn/product-p262797660.html?spid=262797661,180000,90000,50,12,4.8
253284241,8122369775023,Bản đồ về dòng tiền: Hiểu và áp dụng sơ đồ kế toán trong doanh nghiệp và đời sống,102600,https://tiki.vn/product-p253284241.html?spid=253284242,145000,42400,29,12,5.0
197637447,5994045737522,Fullmetal Alchemist - Cang Giả Kim Thuật Sư - Fullmetal Edition Tập 11,66800,https://tiki.vn/product-p197637447.html?spid=129355971,69000,2200,3,19,5.0
195190269,2800658011025,Combo Anime Comics: One Piece Film Strong World (2 Cuốn),154000,https://tiki.vn/product-p195190269.html?spid=195190270,154000,0,0,25,5.0
193450572,8081820325100,Quái Mèo Độc Tấu,84490,https://tiki.vn/product-p193450572.html?spid=193450573,119000,34510,29,62,5.0
192339427,9115930291567,Bà Bác Khủng Khiếp,97500,https://tiki.vn/product-p192339427.html?spid=192339429,150000,52500,35,55,5.0
190705661,6117697758888,Lại Thằng Nhóc Emil,70850,https://tiki.vn/product-p190705661.html?spid=190705662,109000,38150,35,40,4.8
188960732,1995487153854,COMBO TỰ HỌC TAROT: Sách Nhật ký Tarot + Bộ Bài & Sách Hướng Dẫn (Tái bản 2022),299000,https://tiki.vn/product-p188960732.html?spid=188960733,398000,99000,25,72,4.8
185232571,7587330865653,Tiếng Anh 7 Right On! Workbook (Sách bài tập),65000,https://tiki.vn/product-p185232571.html?spid=185232572,65000,0,0,10,5.0
183539219,7803632878817,Thằng Huyện Con Hầu,65000,https://tiki.vn/product-p183539219.html?spid=183539220,89000,24000,27,161,5.0
182149648,5380188826976,Nước Ép Trị Liệu Và Chế Độ Ăn Theo Phương Pháp Cơ Thể Tự Chữa Lành,153200,https://tiki.vn/product-p182149648.html?spid=182149649,199000,45800,23,51,4.8
181699658,9095516235077,Chiến Lược Giao Dịch Của Jesse Livermore,95400,https://tiki.vn/product-p181699658.html?spid=181699659,159000,63600,40,53,4.5
168559524,1068345484330,Gia Đình Tỉnh Thức,135850,https://tiki.vn/product-p168559524.html?spid=168559525,209000,73150,35,77,5.0
155463025,2853855943951,Nghệ Thuật Bán Hàng Bậc Cao - Bí Quyết Chốt Deal Mọi Thời Đại (Khổ Lớn)(Tái Bản),135500,https://tiki.vn/product-p155463025.html?spid=155463026,198000,62500,32,128,5.0
147920905,6317936015280,Đường Mây Qua Xứ Tuyết (Tái Bản),90900,https://tiki.vn/product-p147920905.html?spid=147920906,118000,27100,23,130,5.0
99992416,9077633111743,Fullmetal Alchemist - Cang giả kim thuật sư - Fullmetal Edition - Tập 10,66900,https://tiki.vn/product-p99992416.html?spid=108130511,69000,2100,3,1,5.0
95089986,7200720178219,Bút chì màu gốc dầu cao cấp Deli - 6565 / 6566 / 6567,149000,https://tiki.vn/product-p95089986.html?spid=95089993,268200,119200,44,381,4.8
89204253,9380926461405,4000 Từ Vựng Và Mẫu Câu Tiếng Anh Thiết Yếu Cho Trẻ Em,177500,https://tiki.vn/product-p89204253.html?spid=89204254,250000,72500,29,80,5.0
89001327,3757500321688,Giao Dịch Theo Xu Hướng Để Kiếm Sống,366000,https://tiki.vn/product-p89001327.html?spid=89001328,366000,0,0,209,4.7
73120237,9825899245414,Đừng Coi Thường Sự Lười Học Của Con Người,88000,https://tiki.vn/product-p73120237.html?spid=73120238,135000,47000,35,42,4.7
72202103,7957457609597,Con Chim Xanh Biếc Bay Về (Nguyễn Nhật Ánh) (Bìa Mềm),98940,https://tiki.vn/product-p72202103.html?spid=72102027,150000,51060,34,4376,5.0
68456842,3610874472086,Bài Tập Tiếng Anh 8 - Không Đáp Án,30800,https://tiki.vn/product-p68456842.html?spid=68456843,40000,9200,23,102,5.0
67712912,4731276342568,Phát Triển Trí Tuệ Cảm Xúc- Chúng Mình Tôn Trọng Cơ Thể Và Cảm Xúc Của Nhau,32500,https://tiki.vn/product-p67712912.html?spid=67712913,50000,17500,35,139,5.0
58627102,2649300379539,Sổ Tay Nhà Thôi Miên,104000,https://tiki.vn/product-p58627102.html?spid=58627103,145000,41000,28,1190,4.7
55589742,7695946087685,Sách Bài Học Diệu Kỳ Từ Chiếc Xe Rác (Khổ Lớn) (Tái Bản),85400,https://tiki.vn/product-p55589742.html?spid=55589743,108000,22600,21,285,4.8
46723656,3133779457373,Sách Tử Tế Đáng Giá Bao Nhiêu,75500,https://tiki.vn/product-p46723656.html?spid=46723660,98000,22500,23,297,4.8
45321630,4170434156294,Bạn Chỉ Tưởng Là Mình Đang Rất Cố Gắng,79950,https://tiki.vn/product-p45321630.html?spid=45321631,123000,43050,35,228,4.8
40933973,7401879686495,Dịch Kinh Tường Giải (Di Cảo): Quyển Thượng (Tái Bản),240800,https://tiki.vn/product-p40933973.html?spid=40933974,340000,99200,29,231,5.0
13065341,2067479424544,Series Địch Công Kỳ Án Tập 16 - Quảng Châu Án,94800,https://tiki.vn/product-p13065341.html?spid=13065342,158000,63200,40,7,3.9
11508322,1024179798109,Nội Tình Của Ngoại Tình,161000,https://tiki.vn/product-p11508322.html?spid=11508323,220000,59000,27,326,4.8
5743603,7091611699748,Vật Lý Thiên Văn Cho Người Vội Vã,52000,https://tiki.vn/product-p5743603.html?spid=5866065,80000,28000,35,217,4.8
1926761,2142434979274,Khởi Nghiệp Bán Lẻ - Bí Quyết Thành Công Và Giàu Có Bằng Những Cửa Hàng Đông Khách - Công Thức Kinh Doanh Và Quản Lý Cửa Hàng Hiệu Quả,125000,https://tiki.vn/product-p1926761.html?spid=1926763,199000,74000,37,2310,4.8
1565657,5501192327333,Dốc Hết Trái Tim - Cách Starbucks Xây Dựng Công Ty Bằng Từng Tách Cà Phê (Tái Bản 2018),104070,https://tiki.vn/product-p1565657.html?spid=1566605,150000,45930,31,638,4.8
568762,2512172816078,Tam Quốc Diễn Nghĩa (Trọn Bộ 04 Tập),192500,https://tiki.vn/product-p568762.html?spid=17509940,350000,157500,45,754,4.7
276305333,1489923380374,Vẻ Đẹp Của Cảnh Sắc Tầm Thường - Hay Vì Sao Chúng Ta Cần Thay Đổi Cách Thưởng Thức Thiên Nhiên? (Đặng Hoàng Giang) - Omega Plus,180950,https://tiki.vn/product-p276305333.html?spid=276388459,235000,54050,23,0,0.0
276275663,9558852420362, Ở tiệm bánh Mùa Thu,74750,https://tiki.vn/product-p276275663.html?spid=276275667,115000,40250,35,4,5.0
275748866,2944626363374,Về Chuyện Tôi Chuyển Sinh Thành Slime - Tập 4,143000,https://tiki.vn/product-p275748866.html?spid=275749965,175000,32000,18,1,5.0
275140696,8208547644949,Hậu Cung Như Ý Truyện Tập 4,177000,https://tiki.vn/product-p275140696.html?spid=275141404,229000,52000,23,6,5.0
274930271,1676830833746,Aoki Và Tengoku – Tập 1,69500,https://tiki.vn/product-p274930271.html?spid=274944656,94000,24500,26,3,5.0
273552481,9268382775724,Giải Mã COPYWRITING Write Your Brand Lit,136000,https://tiki.vn/product-p273552481.html?spid=273552482,189000,53000,28,6,4.8
272854044,7271604248980,Sách Tiếng Anh Giao Tiếp Bệnh Viện dành cho người mới bắt đầu - Tác giả BS. Đỗ Trung Kiên (Phiên bản mới nhất 2024),229000,https://tiki.vn/product-p272854044.html?spid=272854045,299000,70000,23,33,4.8
272447731,2013013188747,Xông vào lối âm dương,117700,https://tiki.vn/product-p272447731.html?spid=262806375,169000,51300,30,48,5.0
272421625,3462657654141,Mặt Lợi Của Góc Tối,93800,https://tiki.vn/product-p272421625.html?spid=272421626,131000,37200,28,10,5.0
253365659,8345564837479,"Trọn Bộ Giáo Trình Destination Grammar & Vocabulary B1, B2, C1&C2 (Kèm Đáp Án) Lẻ/combo",141750,https://tiki.vn/product-p253365659.html?spid=253365665,189000,47250,25,64,4.8
195885674,6507223294581,Đất Nước Gấm Hoa - Atlas Việt Nam,280000,https://tiki.vn/product-p195885674.html?spid=195885677,350000,70000,20,33,4.8
193895769,6451152943105,"Cao Thủ ""Đổi Đen Thay Trắng"" - Tập 6 (Tiểu thuyết)",110700,https://tiki.vn/product-p193895769.html?spid=193895770,159000,48300,30,82,5.0
192125793,6808759506980,Harry Potter và tên tù nhân ngục Azkaban (Tái Bản 2022),129000,https://tiki.vn/product-p192125793.html?spid=192125796,205000,76000,37,102,5.0
191655862,3692087180039,"[Combo Manga] Diệt Slime Suốt 300 Năm, Tôi Levelmax Lúc Nào Chẳng Hay (Tập 8 + 9)",175000,https://tiki.vn/product-p191655862.html?spid=191655863,184000,9000,5,217,5.0
191636255,9602775962817,Chòm Sao Linh Thú Tập 7 [Tặng Kèm Bookmark],36000,https://tiki.vn/product-p191636255.html?spid=191636257,40000,4000,10,51,5.0
187827433,4856264525628,Sau Tang Lễ,95600,https://tiki.vn/product-p187827433.html?spid=187827435,145000,49400,34,95,5.0
181699688,2325149616850,Husky Và Sư Tôn Mèo Trắng Của Hắn - Tập 3,105600,https://tiki.vn/product-p181699688.html?spid=181699689,169000,63400,38,180,5.0
176824199,5743749870096,Thần Số Học - Làm Chủ Cuộc Đời,89700,https://tiki.vn/product-p176824199.html?spid=176824201,138000,48300,35,147,4.8
173763066,8972725601043,Chúng Ta Lớn Lên Theo Cảm Xúc Của Mẹ,68800,https://tiki.vn/product-p173763066.html?spid=173763069,96000,27200,28,40,4.8
172206434,2503140228806,Huyền Thuật Và Các Đạo Sĩ Tây Tạng (Tái Bản),83200,https://tiki.vn/product-p172206434.html?spid=172206435,108000,24800,23,99,5.0
171055469,6744087833715,TikTok Tất Tần Tật,119000,https://tiki.vn/product-p171055469.html?spid=171055470,158000,39000,25,65,4.7
165150427,7774988514051,Combo Osho (Suy Ngẫm Đầu Tiên Vào Buổi Sáng + Suy Ngẫm Cuối Cùng Vào Buổi Tối) - Tái Bản,204000,https://tiki.vn/product-p165150427.html?spid=165150432,318000,114000,36,59,5.0
165030729,1605330498488,Những Kẻ Âu Lo,118800,https://tiki.vn/product-p165030729.html?spid=165030730,180000,61200,34,94,5.0
151597552,8003162968533,American Jetstream Pre-Intermediate B Student's book & Workbook ( không kèm CD),207000,https://tiki.vn/product-p151597552.html?spid=151597553,207000,0,0,49,5.0
148802194,1398497472934,Bản Đồ Các Ngày,113750,https://tiki.vn/product-p148802194.html?spid=148802199,175000,61250,35,163,4.8
273714632,6179858176881,Trí Tuệ Do Thái (Tái Bản),136080,https://tiki.vn/product-p273714632.html?spid=50741309,189000,52920,28,65,4.8
270854210,5822612894707,Combo 4 cuốn Biến Mọi Thứ Thành Tiền Q1 + Tư Duy Ngược + Tư Duy Mở + Bí Mật Hành Vi - SBOOKS,291000,https://tiki.vn/product-p270854210.html?spid=270854211,582000,291000,50,11,5.0
212356656,9542554420530,Content Bạc Tỷ (Tái bản 2022),105610,https://tiki.vn/product-p212356656.html?spid=212356658,179000,73390,41,72,4.8
196518832,4576878838494,Khi Băn Khoăn Hãy Cùng Nói Chuyện,73200,https://tiki.vn/product-p196518832.html?spid=196518834,99000,25800,26,7,5.0
194197858,5243546517371,Achievers grade 7 Workbook,112000,https://tiki.vn/product-p194197858.html?spid=194197859,112000,0,0,19,5.0
192909289,3821493304360,"Quán Rượu Dị Giới ""Nobu"" - Tập 09",36700,https://tiki.vn/product-p192909289.html?spid=192909290,40000,3300,8,46,5.0
190242072,2318086982246,Qủy Ấn - Bộ 2 tập ( Tập 1 và 2) - tặng kèm 1 bookmark,288000,https://tiki.vn/product-p190242072.html?spid=190242073,291000,3000,1,130,5.0
189643106,3790533189352,Tự Tôn,99710,https://tiki.vn/product-p189643106.html?spid=189643111,169000,69290,41,29,5.0
189557422,7198648410169,THINK OUT OF THE BOOK - Nghĩ Ngoài Sách Vở,209000,https://tiki.vn/product-p189557422.html?spid=191453205,220000,11000,5,0,0.0
185409035,5200334461387,Bút Bi Nước Mực Gel Bấm Ngòi 0.5mm Deli - Có Ngòi Thay Thế Viết Trơn Đều Phù Hợp Ghi Chép Văn Phòng Học Sinh Sổ Tay - A575,2800,https://tiki.vn/product-p185409035.html?spid=202509424,5400,2600,48,244,5.0
177569697,1025713778365,Perfect Ielts Vocabulary (Tái Bản),166460,https://tiki.vn/product-p177569697.html?spid=177569703,259000,92540,36,96,5.0
176831144,6562200185259,Combo 23 Tập Thanh Gươm Diệt Quỷ (Tập 1-23),575000,https://tiki.vn/product-p176831144.html?spid=176831145,575000,0,0,45,5.0
170345811,3933174057998,Phân Tích Khách Hàng For Dummies,148850,https://tiki.vn/product-p170345811.html?spid=170345812,229000,80150,35,27,5.0
153518828,3769761058250,Hong Tay Khói Lạnh (Tản Văn Nguyễn Ngọc Tư),66660,https://tiki.vn/product-p153518828.html?spid=153518829,90000,23340,26,346,5.0
146271773,7095919538930,Nghiệp Tình Yêu - Karma Of Love (Tái Bản 2021),151000,https://tiki.vn/product-p146271773.html?spid=146271774,199000,48000,24,37,5.0
145092110,9384185039715,Cách Biến Đổi Câu Trong Tiếng Anh,61600,https://tiki.vn/product-p145092110.html?spid=145092111,80000,18400,23,104,4.8
141472522,8517699359971,Sách: Cẩm Nang Tuổi Dậy Thì Dành Cho Bạn Gái (Tái Bản),85000,https://tiki.vn/product-p141472522.html?spid=141472523,100000,15000,15,58,5.0
130230750,1887100441977,Combo 10 Tập - Truyện tranh song ngữ Việt-Anh dành cho trẻ em - Cùng học cư xử tốt,225000,https://tiki.vn/product-p130230750.html?spid=130230751,280000,55000,20,32,5.0
113540588,7458430511107,Thiên Táng,85400,https://tiki.vn/product-p113540588.html?spid=115246673,96000,10600,11,21,5.0
113540577,2086677111908,Anne Tóc Đỏ Dưới Chái Nhà Xanh,77350,https://tiki.vn/product-p113540577.html?spid=113540579,119000,41650,35,370,5.0
109298270,4041537471545,Sách Cẩm Nang Con Gái (Tái Bản),52400,https://tiki.vn/product-p109298270.html?spid=109298271,68000,15600,23,98,4.8
105614665,5384907371448,Bút bi bấm ngòi 0.7mm mực xanh Deli - Màu sắc theo lựa chọn -  1 chiếc - EQ199-BL,4500,https://tiki.vn/product-p105614665.html?spid=271072949,8100,3600,44,233,4.8
90679276,9492819983880,Mở Cửa Tương Lai,147000,https://tiki.vn/product-p90679276.html?spid=90679277,200000,53000,27,535,5.0
87149160,4150239696632,Bộ Cọ Vẽ Chuyên Nghiệp Deli - Dùng Cho Màu Nước/Bột/Sơn Acrylic -Set 4/6 Cây- 73885/73866/73867,32000,https://tiki.vn/product-p87149160.html?spid=87149171,63000,31000,49,288,4.7
83396665,7800466012545,Hướng dẫn khởi động & 200 tư thế Yoga từ cơ bản đến nâng cao,125000,https://tiki.vn/product-p83396665.html?spid=83396666,185000,60000,32,176,4.8
77900450,6241290330917,Đạo Phật Vỡ Lòng (Tái Bản),44850,https://tiki.vn/product-p77900450.html?spid=77900451,69000,24150,35,42,5.0
72542509,8544005291503,Raw Vegan – Sức Mạnh Chữa Lành Của Thực Vật (Tặng kèm bookmark),64300,https://tiki.vn/product-p72542509.html?spid=72542510,92000,27700,30,1392,4.8
68049234,2625715192758,Đừng Để Mất Bò - 7 Bước Quản Lý Cửa Hàng Hiệu Quả Và Chống Thất Thoát,149000,https://tiki.vn/product-p68049234.html?spid=68049235,169000,20000,12,739,5.0
48329799,7560106222100,Tự Học Toàn Diện Hóa Học - Từ Cơ Bản Đến Nâng Cao Lớp 9,65000,https://tiki.vn/product-p48329799.html?spid=48329800,99000,34000,34,386,4.7
46259908,2520154757011,Fibonacci Trading,299000,https://tiki.vn/product-p46259908.html?spid=46259909,299000,0,0,709,4.7
38436464,5743050808480,Khác Biệt Để Bứt Phá (Tái Bản 2019),103000,https://tiki.vn/product-p38436464.html?spid=38436465,128000,25000,20,214,4.7
27971953,4841277701742,Lược Sử Tôn Giáo,83850,https://tiki.vn/product-p27971953.html?spid=27971954,129000,45150,35,663,4.7
12533371,8204992877028,Đạo Đức Kinh,62370,https://tiki.vn/product-p12533371.html?spid=12533372,99000,36630,37,99,5.0
10379317,9369673620818,Nghệ Thuật Giao Tiếp Để Thành Công (Tái Bản 2019),130100,https://tiki.vn/product-p10379317.html?spid=21297565,169000,38900,23,47,5.0
5852521,6294309461486,Combo Cà Phê Cùng Tony và Trên Đường Băng,149600,https://tiki.vn/product-p5852521.html?spid=9365728,210000,60400,29,1984,5.0
276353077,8849219496545,Cùng Cha Mẹ Già Đi,90300,https://tiki.vn/product-p276353077.html?spid=276353079,119000,28700,24,2,5.0
276236721,2915083965056,Nexus - Lược Sử Của Những Mạng Lưới Thông Tin Từ Thời Đại Đồ Đá Đến Trí Tuệ Nhân Tạo (Yuval Noah Harari),243750,https://tiki.vn/product-p276236721.html?spid=276393570,325000,81250,25,0,0.0
276106317,3794040362128,Asari - Cô Bé Tinh Nghịch Kỉ Niệm 40 Năm,19750,https://tiki.vn/product-p276106317.html?spid=276106318,25000,5250,21,1,5.0
275274560,7814696389297,Hồ Sơ Tâm Lý Phạm Tội – Tập 5,194000,https://tiki.vn/product-p275274560.html?spid=275399071,229000,35000,15,0,0.0
274546139,1497126019773,Tiếng thét câm lặng,162500,https://tiki.vn/product-p274546139.html?spid=274546143,250000,87500,35,4,5.0
273691873,6927797707330,Những chuyện lạ ở Tokyo,71500,https://tiki.vn/product-p273691873.html?spid=273691876,110000,38500,35,25,5.0
273548120,9843565871747,Tâm Trí Chữa Lành Cơ Thể Như Thế Nào,153600,https://tiki.vn/product-p273548120.html?spid=273548122,239000,85400,36,2,5.0
273401813,6184783624476,Tết Ở Làng Địa Ngục,111540,https://tiki.vn/product-p273401813.html?spid=162140223,169000,57460,34,353,4.8
272003250,4209402896062,Dragon Ball Full Color - Phần Năm: Truy Lùng Cell Bọ Hung - Tập 1,74700,https://tiki.vn/product-p272003250.html?spid=272003253,77000,2300,3,87,5.0
270745659,4691760623774,Rèn Luyện Tư Duy Hệ Thống Trong Công Việc,77400,https://tiki.vn/product-p270745659.html?spid=270745660,129000,51600,40,9,5.0
214495555,9043699307467,An Nam Truyện - Ghi Chép Về Việt Nam Trong Chính Sử Trung Quốc Xưa (Tái Bản 2022),130000,https://tiki.vn/product-p214495555.html?spid=214495556,200000,70000,35,29,4.7
196394972,7481240054267,Thương Tiến Tửu - Tập 2,169000,https://tiki.vn/product-p196394972.html?spid=272281141,169000,0,0,0,0.0
196305158,4187906620392,Vì Cuộc Đời Không Hẹn Lần Sau,104000,https://tiki.vn/product-p196305158.html?spid=196305160,139000,35000,25,23,5.0
195662905,8640466862034,Circe,164000,https://tiki.vn/product-p195662905.html?spid=195662907,200000,36000,18,43,5.0
193896561,2813201804815,Ninja Rantaro - Tập 59,38900,https://tiki.vn/product-p193896561.html?spid=193896562,40000,1100,3,42,5.0
193450565,4526144736209,Nam Đình Cốc Vi– Tập 7 -  Tặng 1 Postcard Nam Đình Cốc Vi,97900,https://tiki.vn/product-p193450565.html?spid=193450566,119000,21100,18,46,5.0
189326211,8481374704711,Văn phòng thám tử quái vật - Tập 08,26300,https://tiki.vn/product-p189326211.html?spid=189326214,30000,3700,12,74,5.0
187827445,7157203119782,Lược Sử Thời Gian,80830,https://tiki.vn/product-p187827445.html?spid=187827446,115000,34170,30,137,5.0
186578993,3151635904321,Đu Đưa Trên Ngọn Cây Bàng,76700,https://tiki.vn/product-p186578993.html?spid=186578994,118000,41300,35,25,5.0
185408437,6276326923004,"Bút Bi Nước Mực Gel Bấm Ngòi 0.5mm Deli - Mực Đen Nhanh Khô, Viết Đều, Trơn Tru, Phù Hợp Văn Phòng Học Sinh - S08-B",6500,https://tiki.vn/product-p185408437.html?spid=185408443,11700,5200,44,84,4.8
167940010,9924509394048,Thao Túng Tâm Lý,109850,https://tiki.vn/product-p167940010.html?spid=197748193,169000,59150,35,48,4.8
161383826,9156666945926,Đảo Mộng Mơ (Tái Bản),75000,https://tiki.vn/product-p161383826.html?spid=252714518,75000,0,0,0,0.0
158235745,2702508186825,"Phương Pháp Kaizen
 (The Kaizen Way)(Tái Bản)",59850,https://tiki.vn/product-p158235745.html?spid=158235749,95000,35150,37,68,5.0
151597256,9593871203785,American Jetstream Elementary A Student's book & Workbook ( không kèm CD),207000,https://tiki.vn/product-p151597256.html?spid=151597259,207000,0,0,6,5.0
148008757,3793055649945,"Combo 2 Cuốn ""Tim Marshall"": ""Những Tù Nhân Của Địa Lý"" + ""Chia Rẽ - Tại Sao Chúng Ta Đang Sống Trong Thời Đại Của Những Bức Tường""",266500,https://tiki.vn/product-p148008757.html?spid=148008758,410000,143500,35,176,5.0
142833447,1199766199335,Sanctify - Tập 3,90200,https://tiki.vn/product-p142833447.html?spid=142833448,109000,18800,17,512,5.0
130863107,5183399154194,"Sách Người Tìm Xác tập 1+2 - Truyện trinh thám, linh dị",209000,https://tiki.vn/product-p130863107.html?spid=130863108,378000,169000,45,157,5.0
112332742,4755638301959,English Grammar In Use - 130 Bài Ngữ Pháp Tiếng Anh (Tái Bản),113000,https://tiki.vn/product-p112332742.html?spid=112332744,165000,52000,32,232,4.8
94132196,5831163643069,Bộ Luật Lao Động Hiện Hành (Mới Nhất) Thông Qua Tại Kỳ Họp Thứ 8 Quốc Hội Khóa XIV,56000,https://tiki.vn/product-p94132196.html?spid=94132197,119000,63000,53,65,4.8
76531748,1213900618551,Sách DevUP,119200,https://tiki.vn/product-p76531748.html?spid=76531749,149000,29800,20,297,4.7
